choajuo	ba'urnoi	$n_1=b_2$ is a spoken/uttered message about subject $n_2$ uttered by $n_3=b_1$ to intended audience $n_4$.
choatoatoaı	ba'urvlasle	$s_1=b_2$ is a phoneme/most basic phonological subunit of word, meaning/causing $v_2$ in language $v_3$. 
choagıkuq	ba'urxausku	$b_1=c_1$  (agent) eloquently speaks/verbally expresses  $x_1=c_2$ (sedu'u/text/lu'e concept) for audience $c_3$, good/beneficial/nice for $x_2$ by standard $x_3$.
choagıkuqdıu	ba'urxauskuske	$s_1$ is a rhetoric [formal study] of rhetorical matter $s_2$ based on methodology $s_3$.
jaraguobe	bajbakni	$x_1$ is an antelope (any of various bovids) of species $x_2$.
jaratıshaı	bajli'a	$b_1=c_1$ runs away from $c_2$ via route $c_3$ on surface $b_2$ using limbs $b_3$ with gait $b_4$.
guobeshoı	bakcmo	$c_1=b_1$ moos expressing $c_3$ (property).
guobejue	bakma'i	$m_1$ is May of year $m_2$ in calendar $m_3$.
suoıchua	balcme	$x_1$ is the title (honorific appellation) of $x_2$ used by $x_3$
suoıjoe	balcre	$x_1$ is a master of/at $x_2$ (ka)
suoınıaı	balda'u	$x_1$ is a beast, an imposing/terrible/great creature, of species $x_2$
suoıguo	balgu'e	$g_1=b_1$ is an empire of peoples $g_2$ with land/territory $g_3$.
suoısoı	baljamna	$j_1$ fights a great war against $j_2$ over territory/matter $j_3$.
suoıkua	balku'a	$k_1$ is a Hall in structure $k_2$ surrounded by partitions/walls/ceiling/floor $k_3$ (mass/jo'u).
suoıkuamarao	balkumdansu	$d_1$ (individual, mass) ballroom dances to accompaniment/music/rhythm $d_2$.
suoıruaıcue	balnoltru	$t_1=n_1=b_1$ is the emperor/empress/kaiser/tsar of peoples/territories $t_2$.
suoısoıche	balsoi	$s_1=b_1$ is a great soldier of army $s_2$ great in property $b_2$ (ka) by standard $b_3$.
suoıdıem	balzai	$x_1$ is a supermarket selling $x_2$ operated by $x_3$
zuzu	banbau	$b_1$ is a metalanguage used by $b_2$ to talk about object language $b_3$.
zushodıu	banbixske	$s_1$ is historical/diachronic linguistics of/about subject matter $s_2$ based on methodology $s_3$.
zufıeqme	banfingri	$g_1$ is a language-creation/conlanging society/group/club.
zubeodıu	bangafske	$s_1$ is historical/diachronic linguistics of/about subject matter $x_2$ based on methodology $x_3$.
zusoaodıu	banjikske	$s_1$ is sociolinguistics based on methodology $s_2$.
zurıoqlıaq	banklemei	$x_1$ is a language with dialects $x_2$ (full set)
zumoıchudıu	banmenske	$s_1$ is psycholinguistics based on methodology $s_2$.
zuchoqdıu	banpliske	$s_1$ is pragmatics based on methodology $s_2$.
zuraq	banra'a	$s1$ pertains to language of $s2=b2$
zudıupoq	banskepre	$p_1$ is a linguist (scientist).
zuchoalaqtoaı	banvoksle	$s_1$ (phone/speech sounds; specifically is linguistic and vocal) is a phoneme in/of segment of utterance/speech stream $s_2=v_1$ in language $b_1$ of speaker $v_2=b_2$ in order to communicate/express $b_3$ (si'o/du'u; not quote(?)), produced with body-parts/tools $x_6$ at loci/in position/manner (of articulation) $x_7$
buıhıe	barbei	$x_1$ exports $x_2$ to $x_3$ from $x_4$ via $x_5$.
buıshatı	barcreka	$c_1=b_1$ is a jacket of material $c_2$.
buıhıu	barfle	$x_1$ is a stream of $x_2$ flowing out of $x_3$.
buıgaı	barga'e	$x_1$ (observer/perceiver) senses external stimulus $x_2$ via means $x_3$ (sense/sensor) under conditions $x_4$; $x_3$ is a sense organ/exteroperceptor used to observe $x_2$ which is outside the observer $x_1$ under conditions $x_4$.
buırıa	barkalri	$x_1$ is an exit/outlet/way out of $x_2$ for $x_3$.
buıfatua	barklagau	$g_1$ ejects $k_1$ from $b_2=k_3$ via $k_4$ using means $k_5$.
buıtıshaı	barli'a	$x_1=c_1$ leaves/exits/goes outside of $x_2=c_2=b_2$ via route $x_3=c_3$.
buıdoaq	bartca	$x_{1}$ is a city with polity with city $x_{2}$. ( $x_{3}$ = tcadu3 (polity with city) is the main city).
zubeoq	baucmu	$c_1$ is the basis of language $c_2=b_1$ used by $b_2$ to express/communicate $b_3$ (si'o/du'u, not quote).
zumıu	bausmu	$x_1$ is the meaning of linguistic expression $x_2$ in language $x_3$ according to interpreter $x_4$
bıeshao	bavdji	$d_1$ desires/wants/wishes for future $d_2$ (event/state) for purpose $d_3$ with desired future point $b_1$. $d_1$ aspires.
bıetuamoı	bavgaupei	$g_1=p_1$ thinks about/considers/ponders/reflects upon doing $b_1=g_2=p_2$ (nu) after $b_2$ (nu)
bıemıu	bavji'i	$x_1$ predicts that $x_2$ (du'u) is true in/about future time/place $x_3$ on grounds $x_4$.
bıeleaqjue	bavla'ima'i	$m_1=b_1=l_1$ is the next month; $m_1=b_1=l_1$ is the month following $b_2=l_2$, month standard $m_3$.
bıeleaqnuaq	bavlamcte	$n_1=l_1=b_1$ is the night after $b_2=l_2$ at location $n_3$.
bıeleaqchaq	bavlamdei	$d_1=b_1=l_1$ is tomorrow; $d_1=b_1=l_1$ is the day following $b_2=l_2$, day standard $d_3$.
bıeleaqjoa	bavlamjeftu	$j_1=b_1$ is the week directly after $b_2$ by standard $j_3$.
bıeleaqguo	bavlamke'u	$x_1$ is the next/following time that $x_2$ happens.
bıeleaqnıaq	bavlamna'a	$n_1=b_1=l_1$ is next year; $n_1=b_1=l_1$ is the year following $b_2=l_2$ by year standard $n_3$.
bıemoaqbudeq	bavmojnalka'e	$k_1$ is unable to/incapable of remembering future $k_2$ under conditions $k_3$. $k_1$ has anterograde amnesia/memory loss.
bıefeo	bavyfa'a	$x_1$ is futureward/to the futureward side/in the future of $x_2$ in frame of reference/according to observer or vantage point $x_3$.
bıechı	bavykri	$x_1$ expects/anticipates $x_2$ to happen.
bıetaq	bavyse'i	$x_1$ is the future self/identity of $x_2$; $x_1$ is $x_2$ in the future.
bıedıu	bavyske	$s_1$ is futurology/future studies of/about ideas of the future $b_1=s_2$ based on methodology $s_3$.
bıeseo	bavyspe	$s_1$ is the fiancé(e)/betrothed of $s_2$ under law/custom/tradition/system/convention $s_3$.
bıeruaq	bavyxusra	$x_1$ asserts/prophesies that $x_2=b_1$ is true about the future of $b_2$.
hıepoq	beipre	$p_1=b_1$ is a carrier/porter/waiter, carrying $b_2$ to $b_3$ from $b_4$ over path $b_5$.
bıadu	bi'amlu	$s_1=b_1$ is sickly/appears ill with symptoms $s_2=b_2$ from disease $b_3$ to observer $s_3$.
bıasho	bi'arbi'o	$bin_1$ develops illness $bin_2=bil_1$ with symptoms $bil_2$.
bıatua	bi'argau	$x_1=g_1$ makes $x_2=b_1$ be sick from disease $x_3=b_3$; $x_1=g_1$ sickens $x_2=b_1$; $x_1=g_1$ is a pathogen
bıaleu	bi'arlitki	$l_1$ is pus of composition $l_2$ from disease $b_3$.
bıamoıchudıu	bi'armenske	$s_1$ (mass of facts) is the psychiatry of subject matter $s_2$ based on methodolgy $s_3$.
goeqfuaq	bimxra	$p_1$ is a mural representing/showing $p_2$, made by artist $p_3$ on wall $p_4=b_1$.
rıepoq	binpre	$j_1=p_1$ is a middleman/mediator/contact/go-between/intercessor between parties $j_2$.
rıedueq	bintu'a	$j_1=t_1$ is a parcel/expanse of land between/among set of points/bounds/limits $j_2$ at location $t_2$. $j_1=t_1$ is in limbo.
gıebeaıfa	birdadykla	$k_1$ brachiates to destination $k_2$ from origin $k_3$ via route $k_4$.
gıejıaı	birjai	$x_1=j_1$ grasps/holds/hugs $x_2=j_2$ with $x_1$'s arms, at locus $x_3=j_4$.
gıefuqpaq	birtafpau	$p_1$ is a sleeve of garment $p_2=t_1$ for wearing by $t_2$ (gender/species).
gıebıucıa	birtu'ucau	$c_1$ (garment) is sleeveless.
gıebıucıashatı	birtu'ucaucreka	$cl_1=cr_1$ is a sleeveless shirt made of material $cr_2$.
shokoaq	bixma'u	$b_1=m_1$ is adolescent / pubescent / maturing in development-quality $m_2$ (ka) by standard $x_3$.
shotua	bixygau	$x_1=b_3=g_1$ makes/turns $x_2=b_1$ into $x_3=b_2$
meaqmeaqmeaqmeaq	bloblobloblo	$x_0$: word used to test the efficiency of a lujvo-building computer program. (nullary predicate)
meaqshaq	blocra	$c_1$ is a prow of boat/ship $c_2=b_1$, boat for carrying $b_2$, propelled by $b_3$.
meaqfeobeaq	blofarga'a	$g_1$ is the tiller made of $g_2$ of boat/ship $f_2=b_1$.
meaqpeo	blogre	$p_1$ ferries through $p_2$ to destination side $p_3$ from origin side $p_4$, carrying $b_2$, propelled by $b_3$.
meaqfa	blokla	$k_1$ goes/sails/navigates (travels by boat) to destination $k_2$ from origin $k_3$ via route $k_4$ using boat $k_5=b_1$.
meaqrıoq	blokle	$x_1$ are a class of boats defined by property $x_2$
meaqcıao	bloklu	$k_1$ is the maritime culture of nation/ethos $k_2$.
meaqrıoq	blolei	$k_1$ is a ship type/class within ships $b_1=k_2$, with features $k_3$.
meaqgıambeaq	blomuvga'a	$g_1$ is an oar/paddle of boat/ship/vessel $b_1$, of material $g_3$, boat for carrying $b_2$.
meaqpoq	blopre	$p_1$ is a sailor of boat $b_1$ of type/that carries $b_2$.
meaqcaq	blosazri	$s_1$ maneuvers/is a pilot of boat $b_1=s_2$.
meaqsoıche	blosoi	$s_1$ is a marine of military unit $s_2$.
meaqpuılıaq	blosormei	$s_1$ is a fleet (of ships).
sıaıhıu	blufle	$f_1$ is blood flow/circulation of vital fluid $f_2=c_1$ of organism $c_2$, flowing in direction to/towards $f_3$ from direction $f_4$.
kuoqlohapıo	bogjimro'i	$x_1$ is a quantity of/is made of/contains limestone from location $x_2$.
kuoqloha	bogjinme	$x_1$ is calcium.
kuoqcıe	bogyfi'e	$f_1$ is a bony fish (Osteichthyes) of species $f_2$.
kuoqdıupoq	bogyskepre	$p_1$ is an osteologist practising osteology $s_1$.
kıoqrıe	bolbi'i	$x_1$ is the whole region of space which is between inner sphere $x_2$ and outer sphere $x_3$.
kıoqjıo	boldi'u	$d_1$ is a dome/cupola for purpose $d_2$.
kıoqluaq	bolkei	$k_1$ plays ball with the ball $k_2=b_1$
kıoqmuq	bolxa'e	$xa_1=b_1$ is the fist of $xa_2$.
saosho	brabi'o	$bi_1=ba_1$ grows in size/becomes big to $bi_2$ under conditions $bi_3$.
saosaoaıpı	brabracrida	$c_1=b_1$ is a giant of mythos/religion $c_2$, huge as compared with standard/norm $b_3$.
saosaosoımeaq	brabrajamblo	$bl_1=ba_1$ is a battleship of type/carrying $bl_2$, propelled by $bl_3$.
saocaı	bracai	$x_1=b_1=c_1$ is huge/enormous/colossal/immense in property $x_2=b_2$ to observer $x_3=b_3=c_3$
saojeq	bradu'i	$d_1$ is of the same size as $d_2$.
saosoımeaq	brajamblo	$bl_1=ba_1$ is a cruiser of type/carrying $bl_2$, propelled by $bl_3$.
saonao	brajau	$x1$ is a big expanse of water, river/sea/lake
saopuecheıpıu	brajmadegycalku	$c_1$ is the nail of the big toe of body $d_3$.
saoruteıjeq	brajvetaidu'i	$d_1$ is/are congruent/has the same shape and size as $d_2$.
saochıeq	brakruca	$k_1$ amply overlaps with $k_2$ at locus $k_3$, amply as compared with standard/norm $b_3$.
saopıo	braro'i	$r_1$ is a boulder/big rock of type/composition $r_2$ from location $r_3$, big as compared with standard/norm $b_3$.
saoheq	bravau	$v_1$ is a large container, containing $v_2$, large as compared with standard/norm $b_3$.
saonaomı	braxamsi	$x_1=b_1$ is an ocean on planet $x_2$ (default Earth) of fluid $x_3$.
saoeku	braxirma	$x_1=b_1$ is a cart/dray/draft horse of breed $x_2$.
saobua	brazda	$x_1$ is a mansion/manor/large house of/for $x_2$, big by standard $x_3$
saojeaqtua	brazengau	$g_1$ causes $z_1=b_1$ to increase in property/dimension $b_2$ (ka) by amount $z_3$.
gueqbua	bu'uzda	$z_1$ is a tent inhabited by $z_2$, made of $b_2$.
gueqshua	bukfa'u	$f_1$ parachutes to $f_2$ from $f_3$ using parachute of type/material $b_2$.
gueqjıo	bukydi'u	$z_1$ is a tent for purpose $z_2$, made of $b_2$.
gueqlıaı	bukyvoi	$v_1$ paraglides, using paraglider of type/material $b_2$.
keacıa	ca'arcau	$cl_1$ is unaided by/without apparatus/mechanism/device/equipment $ca_1=cl_2$ for function $ca_2$ controlled/triggered by $ca_3$ (agent).
naıjao	cabda'o	$x_1$ (nu) happens far away in time from $x_2$ (nu).
naıdıo	cabdo'i	$d_1=c_1=x_1$ is the today daytime period of $c_2=x_2$ at location $n_3=x_3$.
naıjoa	cabjeftu	$j_1=c_1$ is this week; $j_1=c_1$ is the week occuring at the same time as $c_2$, week standard $j_3$.
naırutı	cabjvezva	$x_1$ overlaps in time and space with $x_2$
naıjue	cabma'i	$m_1=c_1$ is the current month by month standard $m_3$, simultaneous with $c_2$ in time.
naınıaq	cabna'a	$n_1$ is the current year by standard $n_3$, simultaneous with $c_2$ in time. 
naıfaq	cabyfau	$c_1=f_1$ is live (experienced as it happens) to experiencer $c_2$.
caısao	caibra	$b_1=c_1$ is huge/enormous/colossal in property $b_2=c_2$ to observer $b_3=c_3$.
caıkaqsı	caicta	$cat_1$ stares at $cat_2$ as received by observer $car_3$.
caıshao	caidji	$d_1$ craves/intensely wishes $d_2$ (event/state) for purpose $d_3$.
caıgı	cairza'a	$x_1$ is an idol
caınoq	caivru	$s_1=c_1$ is roaring/blinding to $s_2$ via sensory channel $s_2=c_3$.
pıusoı	cakyda'a	$x_1=d_1$ is an armoured fighter protected by armuor/shell $x_2=c_1$ covering $x_3=c_2$ of material $x_4=c_3$
pıuchao	cakykarce	$k_1=c_2$ is a tank/armored combat vehicle for carrying $k_2$, propelled by $k_3$, with armor-plating $c_1$.
goarudaq	caljvetei	$c_1=t_1$ is space-time occupied by $c_2$. 
goatoaı	calsle	$x_1$ is a voxel of model/object $x_2$
goateısıu	caltaismi	$x_1$ is shaped (physically/geometrically) like $x_2$, with shape $x_3$
goameta	caltre	$c_1=m_1$ (space/volume/region/room) is $m_2$ cubic metres/meters ($m^3$) measured in perpendicular directions (triple)/defined by set of points (set)/occupied by $c_2=m_3$ by standard $m_4$.
caıbao	camblabi	$x1$ is white
caıjaı	camgei	$g_1$ is intensely happy about $g_2$.
caıcueqca	camgubri'a	$r_1$ hypes $r_2=g_1=c_1$.
caısı	camju'i	$x_1$ concentrates on / pays close attention to $x_2$
caıcho	camnei	$x_1$ loves (emphatically likes) $x_2$ (object/state)
caımaı	campa'i	$c_1=p_1$ intensely loves/feels strong affectionate devotion towards $p_2$ (object/state).
caıreobuqshuao	camskamolcpi	$ci_1=m_2$ is toucan/toucanet of species/type $ci_2$ with bill $m_1=s_1$ of typically intense color or colors $s_2=ca_1$
caıtea	camte'a	$t_1$ feels horror/is intensely frightened of $t_2$ (event/tu'a object).
caıleo	camtoi	$c_1$ effortfully tries to do $t_2$ by method $t_3$, as perceived by $c_3$.
muoıshaq	carcra	$cr_1=ca_1$ turns to face $cr_2$.
muoıtua	cargau	$x_1$ turns $x_2$ around axis $x_3$ in direction $x_4$.
muoıtoe	carka'a	$k_1$ is a rotary saw [rotating cutting tool] cutting/splitting/dividing $k_2$ (object) into pieces $k_3$
muoıhuıgaı	carmalga'e	$x_1$ feels dizzy
ruqmuaodueq	carvyrictu'a	$x_1$ is a rainforest
cıameo	caudri	$x_1$ is sad that they lack $x_2$ (ka); $x_1$ misses $x_2$.
cıajuı	caujbi	$x_1$ is barely $x_2$ (property of $x_1$); $x_1$ has barely / almost doesn't have property $x_2$
cıatua	caurgau	$g_1$ (person/agent) deprives $c_1$ of $c_2$.
ruqtuarıtı	cavgauri'i	$r_1=g_1$ is a rainmaking/ ritual intended to invoke rain $r_2=g_2$, by custom/in community$r_3$, with form/rules$r_4$.
ruqsıqja	cavlu'i	$l_1$ (agent) showers $l_2$.
ruqsıqjachuo	cavlumtci	$x_1$ is a shower head/faucet/nozzle made of material $x_2$ with flow rate $x_3$ and water pressure $x_4$
ruqmuaodueq	cavricfoi	$f_1$ is a rain forest with trees $t_1$.
ruqmuaodueq	cavrictu'a	$x_1$ is a rainforest.
ruqhıu	cavyfle	$f_1=c_1$, consisting of $f_2$,  pours into $f_3=c_2$ from $f_4=c_3$.
ruqtaqsıqja	cavysezlu'i	$l_1=s_1$ (agent) showers itself of soil/contaminant $l_3$ with cleaning material(s) $l_4$.
jıaochı	ceikri	$k_1$ believes (without evidence/proof) that the god/deity $c_1$ exists.
jıaobudua	ceirnalju'o	$d1$ does not know if a god(s) exist; d1 is agnostic.
jıaolaı	ceisni	$x_1=s_1$ is an idol/a sign/symbol representing god/demon/property $x_2=s_2$ to observer $x_3=s_3$
jıaobua	ceizda	$z_1$ is the Heaven of religious community $c_2$.
jıaochua	cevycme	$cmene_1$ is a Divine Name of $cevni_1=cmene_2$ as known by $cevni_2=cmene_3$ which is associated with $cevni_3$; $cmene_1$ is a name of god.
ceobıe	cfabalvi	$b_1$ is entirely in the future of $b_2$; $b_1$ begins after $b_2$.
ceogaı	cfaga'e	$g_1$ notices $g_2$ by means $g_3$ under condition $g_4=c_1$.
ceotua	cfagau	$x_1=g_1$ (person/agent) initiates/begins/starts/causes the beginning of $x_2=c_1$ (state/event/process).
ceopu	cfapru	$p_1$ is preliminary to $c_1=p_2$'s beginning.
ceorıtı	cfari'i	$r_1$ is/are the ritual/proceedings for starting/commencing $c_1$[event/state/process] by community $r_2$ with rules $c_4$.
ceocaq	cfasazri	$s_1$ powers up $s_2$ for function $s_3=c_1$.
ceotuı	cfatse	$x_1$ sits down on $x_2$.
kaılueq	ci'arse'u	$s_1=c_2$ is a secretary to $s_2$.
kaıteı	ci'artai	$t_1$ is a font/writing style used by $c_1$ to write $c_2$ on medium $c_3$ with implement $c_4$.
doemeluaq	ci'erkei	$k_1$ plays game $k_2=c_1$ governed by rules $c_2$ interrelating game parts (physical or conceptual) $c_3$.
saqchaq	cibdei	$x_1$ is a Wednesday of week $x_2$ on calendar $x_3$.
saqzıulıaq	cibnacmei	$x_1$ is a 3-dimensional vector with coordinates $x_2$, $x_3$ and $x_4$.
saqkopıtoa	cibyfu'ivla	$x_1=v_1=f_1$ is a stage 3 fu'ivla meaning $x_2=v_2$, based on word $x_3=f_2$ in language $x_4$.
saqrıalaq	cibykarsna	$x_1$ (sound, text) is a triphthong.
saqpıanete	cibyplini	$p_1$ is the third closest planet revolving around $p_2$, with planetary characteristics $p_3$, orbital parameters $p_4$.
saqshıaq	cibytu'e	$x_1$ is three-legged.
saqsıoqchao	cibyxilma'e	$m_1$ is a tricycle (propelled, three-wheeled vehicle) carrying $m_2$ on surface $m_3$, propelled by $m_4$
puaıdueq	cicfoi	$f_1$ is an uncultivated field of material $f_2$.
puaıpoq	cicpre	$c_1=p_1$ is a savage/wild person.
puaıreq	cicre'a	$c_1=r_1$ is a savage/wild human.
puaımuaodueq	cicricfoi	$f_1$ is a jungle
puaınıu	cicyspa	$s_1=c_1$ is a weed of species $s_2$.
puaınıudueq	cicyspafoi	$f_{1}$ is a brush/shrubland [field of wild plants] with predominant plant species/cultivar $s_{2}$.
puaınıushata	cicyspavi'u	$v_1$ weeds out plants $s_1=c_1$ of species $s_2$ from $v_3$ with/leaving result/remnant/remainder $v_4$.
cuaıasaı	cimde'u	$d_1=c_1$ is a quantityof/contains/is made of mud from source $d_2$ of composition $d_3$, moist due to liquid $c_2$.
cuaıshoemfuq	cimjirta'u	$t_1$ is a wet suit for wearing by $t_2=j_1=c_1$ in liquid $j_2=c_2$.
cuaıca	cimri'a	$r_1$ (event/state) moistens $c_1$ with liquid $c_2$ under conditions $r_3$.
cuaıdueq	cimtu'a	$t_1=c_1$ is a swamp/marsh/wetland at location $t_2$ with liquid $c_2$
kaılea	ciskylarcu	$x_1=l_1$ is calligraphy
nıolıqguobe	citfe'ibakni	$b_1=f_1=c_1$ is a heifer [young female bovine/cow] of species/breed $b_2=f_2$ by standard $f_3=c_2$. 
nıomaı	citpa'i	$p_1$ has a crush on/is infatuated with $p_2$
nıoguobenueq	citybakre'u	$r_1$ is a quantity of/contains veal/bovine meat/flesh from young bovine/cattle $c_2=b_1=c_1$.
nıokune	cityge'u	$g_1$ is a young dog/canine/[bitch]/puppy of species/breed $g_2$.
kuefıeq	ckufi'i	$x_1=f_1=c_3$ authors/creates book $x_2=c_1$ about/containing work $x_3=c_2$ for audience $x_4=c_4$ preserved in medium $x_5=c_5$ for purpose $x_6=f_3$ from elements/ideas/inspiration $x_7=f_4$.
kueguo	ckuke'u	$x_1$ is the $x_3$'rd edition of book/publication $x_2$ about subject/theme/story $x_4$ by author $x_5$ for audience $x_6$ preserved in medium $x_7$ .
kuepaqpaq	ckupaupau	$x_1$ is a part of $x_2$, which is a part of a book . $x_1$ is a part of chapter $x_2$
kuechue	ckupoi	$x_1=p_1$ is a series of books $x_2=c_1=p_3$.
kueshuaq	ckupra	$cup_1$ publishes $cup_2=cuk_1$ by process $cup_3$.
kuebuajoe	ckuzdacre	$c_1$ is a librarian by standard $c_3$.
kuebuadıu	ckuzdaske	$s_1$ is library science with methodology $s_3$.
buaıjarafa	clabajykla	$k_1=b_1$ runs a marathon/long distance to destination $k_2$ from origin $k_3$ via route $k_4$.
buaıtorea	cladakfu	$x_1$ is a long knife
buaıgeajıo	clagaldi'u	$d_1=g_1=c_1$ is a tower for purpose $d_2$.
buaıtua	clagau	$x1=g1$ lengthens $x2=c1$ in property/quantity $x3$ (ka/ni) by amount/excess $x4$
buaıchao	clakarce	$k_1=c_1$ is a limousine for $k_2$, propelled by $k_3$.
buaıboanıaı	clanebda'u	$d_1=cl_1=cn_2$ is a giraffe of species/variety $d_2$.
buaımaı	clapa'i	$p_1$ feels longstanding love/strong affectionate devotion over a long time towards $p_2$.
buaıloma	clapi'e	$x_{1}$ is a leap with leaped to $x_{2}$ with leaped from $x_{3}$ with leap height $x_{4}$ with propulsion for leap $x_{5}$.
buaıpoq	clapre	$p_1$ is a tall person, by measurement standard $c_3$.
buaıdaq	clatei	$t_1$ is a long time/duration/interval/period/elapsed time from time/event $t_2$ to time/event $t_3$.
buaımeta	clatre	$x_1=m_1=c_1$ measures $x_2=m_2$ meters in its longest direction $x_3=m_3=c_2$ by measurement standard $x_4=m_4$.
buaıceukuq	clavaxsku	$x1=v1=c1$ sighs $x2=c2$ (text) to $x3=c3$
nuısho	cmabi'o	$b_1=c_1$ decreases in size/becomes small to $b_2$ under conditions $b_3$.
nuıcaı	cmacai	$ca_1=cm_1$ is tiny/miniature/diminutive/very small in property $ca_2=cm_2$ to observer $ca_3=cm_3$.
nuıkue	cmacku	$cu_1$ is a booklet/brochure about $cu_2$, written by $cu_3$ for intended audience $cu_4$ in medium $cu_5=cm_1$.
nuınuıaıpı	cmacmacrida	$cr_1$ is a fairy [tiny mythical humanoid] of mythos/religion $cr_2$
nuıaıpı	cmacrida	$x_{1}$ is a small-fairy with fairy mythos $x_{2}$.
nuıkaqsıchuo	cmactatci	$t_1$ is a microscope used by $t_2=ca_1$ for looking at small things $t_2=ca_2=cm_1$ which are small in property/dimension(s) $cm_2$ (ka) as compared with standard/norm $cm_3$.
nuılua	cmafi'a	f1=c1 is a short story about plot/theme/subject $c_2$ by author $c_3$.
nuıhıu	cmafle	$x_{1}$ is a small-flow with has flow $x_{2}$ with flow destination  $x_{3}$ with flow source  $x_{4}$ with smallness standard $x_{5}$.
nuıguocue	cmagu'etru	$x_{1}$ is a govern with governed-country-small $x_{2}$.
nuısoımeaq	cmajamblo	$b_1=c_1$ is a destroyer of type/carrying $b_2$, propelled by $b_3$.
nuırıası	cmakarzga	$z_1=k_3$ peeks at $z_2=k_2$ using $z_3$ under conditions $z_4$
nuılaqcaıkea	cmalauca'a	$x_{1}$ is an apparatus with apparatus operator $x_{2}$.
nuınam	cmananba	$n_1$ is a roll/bun/biscuit/bun made from grains $n_2$.
nuıpıo	cmaro'i	$c_1=r_1$ is a small rock of type $r_2$ from location $r_3$, small by standard $c_3$. $c_1$ is gravel.
nuıjaqmeı	cmatcema'a	$cman_1=cmal_1$ is a hillock/mound/rise/knoll in terrain $cman_2$, small by standard $cmal_3$.
nuıjaqjaq	cmatcetce	$m_1=c_1$ is tiny/miniscule/diminutive in property/dimension(s) $c_2$ (ka) as compared with standard/norm $c_3$.
nuımuao	cmatricu	$t_1$ is a brush/bushy vegetation of species/type $t_2$.
nuıdueq	cmatu'a	$x_1=c_1=t_1$ is a patch of land at $x_2=t_2$
nuıeku	cmaxi'a	$xi_1=c_1$ is a pony of species/breed $xi_2$.
nuıbua	cmazda	$z_1$ is a hut of/for $z_1$, small as compared with standard/norm $c_3$.
nuıjeaq	cmaze'a	$z_1=c_1$ shrinks/decreases in property $c_2$ (ka) by amount $z_3$.
nuıjeaqtua	cmazengau	$g_1$ causes $z_1=c_1$ to decrease in property/dimension $b_2$ (ka) by amount $z_3$.
chuadoeme	cmeci'e	$ci_1$ (mass) is a nomenclature/system of names interrelated by nomenclature rules $ci_2$ among names/terms $cm_1=ci_3$ (set (of quoted words)), used by $cm_3$ (person(s)) with systemic functions/properties $ci_4$ (ka).
chuadıu	cmeske	$s_1$ is onomastics/onomatology of/about names $j_1=s_2$ based on methodology $s_3$.
chuareaqtua	cmeveigau	$g_1=v_3$ registers $c_2$ with user-name $c_1$ on system/application $c_3$.
meakoe	cmicu'a	$cm_1=cu_1$ votes for $cu_2$ among choices $cu_3$ in voting group $cm_2$.
meatua	cmigau	$g_1$ puts together $c_1$ into group $c_2$.
mealıaq	cmimei	$x_1$ (collection/sequence) has $x_2$ (number) members
meareaqtua	cmiveigau	$g_1=v_3$ registers $c_1$ as a member of $c_2$, registration preserved in medium $x_3=v_4$.
meatao	cmizu'e	$z_1=c_1$ participates in employing means/taking action $z_2$ for purpose/goal $z_3$.
beoqchı	cmukri	$x_1$ entertains axiomatic belief that $x_2$ is the case.
beoqseao	cmuxu'i	$x_1$ is an element of kind $x_2$ with purity $x_3$.
moemoe	cnicni	$x_1$ feels $x_2$ (ka) about $x_3$ feeling $x_4$ (ka) about $x_5$
moejao	cnida'o	$d_1=c_1$ is far/distant from $d_2$ in feeling $d_3=c_2$.
moechı	cnikri	$x_1$ emotionally believes $x_2$ (du'u) about subject $x_3$
moede	cnimle	$x_1=m_1=c_3$ is romantic to $x_2=m_2$; $x_1$ is beautiful to $x_2$ because it follows or is based on some emotional ideal that may not actually reflect reality.
moepua	cnipu'a	$x_1$ (event/state) feels (emotionally) good / pleasant / nice to $x_2$ under conditions $x_3$
moeteoq	cnirei	$x_1=p_1$ is a question about $x_3=c_2=p_4$’s emotion, asked by $x_2=p_3$ to $x_3=c_3=p_4$.
moeca	cniri'a	$x_1=r_1$ (event) moves/touches $x_2=c_1$ (person), causing emotion $x_3=c_2$ about object of emotion $x_4=c_3$ with causation conditions $x_5=r_3$; $x_1=r_1$ (event) is moving/touching.
moetaq	cnise'i	$s_1$ is the heart (emotional self) of $s_2=c_1$.
moepoe	cnisei	$x_{1}$ is an apart-feels [emotion] with separated from $x_{2}$.
moekuq	cnisku	$x_1=ci_1=cu_1$ expresses emotion $x_2=ci_2=cu_2$/emotionally expresses $x_2$ for audience $x_3=cu_3$ via expressive medium $x_4=cu_4$.
moefuq	cnita'u	$x_{1}$ is a garment with wears garment $x_{2}$ with garment purpose-emotion felt $x_{3}$.
moeceu	cniva'u	$v_1$ sighs due to emotion $c_2$ (ka) about $c_3$ breathing/respiring $v_2$.
suecheo	cpesi'u	$x_1$ ask each other for/request from each other $x_2$ in manner/form $x_3$
suekuq	cpesku	$cu_1=cp_1$ pleas/[expresses request] $cu_2$ (sedu'u/text/lu'e concept)  to $cu_3=cp_3$ via expressive medium $cu_4$.
shuaoteatua	cpitepygau	$x_1$ is a scarecrow for scaring off birds $x_2$
shuaobua	cpizda	$z_1$ is a nest of bird $z_2=c_1$ of genus/species/etc. $c_2$.
shaqlaı	crale'u	$l_1$ is an initial letter in alphabet/character-set $l_2$ representing $l_3$.
shaqtuı	cratse	$x_1$ is a president; $x_1$ is president of $x_2$
shaqkıao	cravro	$v_1=c_1$ is a front door/gateway/access between $v_2$ and $v_3$ of structure $v_4$.
shaqfuaq	craxra	$p_1$ is the front-cover picture/image/illustration showing $p_2$ made by artist $p_3$.
joesho	crebi'o	$c_1=b_1$ becomes expert at $c_2=b_2$ under conditions $b_3$ by standard $c_3$.
joekafeshuaq	crekafpra	$cu_1$ is a barista/is skilled at making coffee drink/product $cu_2=ck_1$ by process $cu_3$.
joeıq	crekai	$x_1$ does $x_2$ in a skilled manner
joeleashuaq	crelarpra	$x_1=ce_1=cu_1$ expertly produces artwork $x_2=cu_2$ of craft/skill $x_3=ce_2=l_2$ by process $x_4=cu_3$ expertly produced by standard $x_5=ce_3$.
joejeaqtao	crezenzu'e	$x_1$ practices/exercises/drills/trains in/for action/event/performance $x_2$.
aıpıdıu	cridyske	$s_1$ (mass of facts) is the science of fairies/elves/pixies [mythical humanoid] of mythos/religion $c_2$ based on methodology $s_3$.
noıseaq	crogle	$g_1$ practices sadomasochism with $g_2=c_1$ with pain at locus $c_2$.
shoereaq	cruvei	$v_1$ is a permit allowing $c_2$ (event) under conditions $c_3$, preserved in medium $v_4$.
nuaqshodaq	ctebixtei	$x_{1}$ is a time interval with day with night $x_{2}$ with night location  $x_{3}$.
nuaqshoıshuao	ctecmocpi	$x_1$ is a nightjar/goatsucker/whippoorwill of genus/species $x_2$.
nuaqshuao	ctecpi	$c_1$ is an owl of species $c_2$.
nuaqpuefuq	ctecutci	$c_1$ is a slipper (shoe primarily for wearing at night) for wearing on [feet/hooves] $c_2$, made of material $c_3$.
nuaqnao	ctejau	$d_1$ is dew.
nuaqsuaqshuao	ctesa'acpi	$x_1$ is a nightingale of species/variety $x_2$.
chuqsue	cticpe	$cp_1$ orders food $ci_2$ for $cp_2$ from $cp_3$ in manner/form $cp_4$.
chuqtorea	ctidakfu	$d_1$ is a table knife for cutting food $d_2=c_2$, with blade of material $d_3$.
chuqshao	ctidji	$x_1$ has appetite for $x_2$
chuqtua	ctigau	$g_1$ feeds $c_1$ with food $c_2$.
galedoeme	ctuci'e	$ci_1$ is an education system interrelated by administrative policies $ci_2$ among institutions $ci_3=ct_1$ displaying quality $ci_4$.
galekue	ctucku	$cu_1=ct_1$ is a textbook for teaching ideas/methods $ct_3$ (du'u), by author $cu_3$ for audience $cu_4=ct_2$ about subject(s) $ct_4$ by method $ct_5$, preserved in medium $cu_5$.
galefaq	ctufau	$f_1$ is a lesson by $c_1$ for teaching audience $c_2$ ideas/methods/lore $c_3$ (du'u) about subject(s) $c_4$ by method $c_5$ (event).
galeguaı	ctugu'a	$x_1=g_1=c_2$ works on $x_2=g_2=c_5$ for teacher $x_3=c_1$ to learn facts $x_4=c_3$ about subject $x_5=c_4$
galetoaı	ctuka'u	$x_1$ is a lesson/unit of teaching
galejuo	ctunoi	$n_1$ are instructions by $c_1$ teaching audience $c_2$ ideas/methods/lore $c_3$ (du'u) about subject(s) $c_4$ by method $c_5$ (event).
tuepoq	cu'upre	$p_1$ is a businessman/business woman involved in business $c_1$.
tuerıa	cu'urkalri	$k_{1}$ (store/company/organization/entrance-way etc) is open/ajar/not shut permitting access to organized activity $k_2=c_1$ by $k_{3}$.
puefuqchao	cucma'e	$m_1$ is a skate carrying $m_2$ on surface/medium $m_3$.
puefuqtıa	cucti'e	$t_1$ is the heel of shoe $t_2=c_1$ for covering/protecting feet $c_2$, and of material $c_3$.
puefuqcheı	cucydegji	$x_1=d_1$ is the toe of shoe $x_2=d_2=c_1$.
moemmuo	cukmu'o	$m_1=c_1$ (object) is completely round/full.
moemzıu	cukna'u	$x_1$ is a round number in base $x_2$.
moemteı	cuktai	$t_1=c_1$ is a circle.
moemfuaqchuo	cukyxratci	$x_1$ is a compass for drawing circles $x_2$.
daıtua	cumgau	$x_1$ enables $x_2$ (event) to happen; $x_1$ makes $x_2$ possible
daıjıaqlua	cumymu'efi'a	$cf_1$ is science fiction about possible universe $cu_1=m_1$ by author $cf_3$.
koeleo	cuxtoi	$x_1$ is trying to choose which of $x_2$ (plural) to be in relation $x_3$ with
soıjoe	da'acre	$x_{1}$ is an expert-fight with opponent [in fight] $x_{2}$ with expertise standard $x_{3}$.
soıcheo	da'arsi'u	$s_1$ fight [each other] over issue $d_3$ (abstract).
soıkeoı	da'arta'a	$t_1=d_1$ quarrels with $t_2=d_2$ about issue $t_3=d_3$ in language $t_4$.
soıkeoı	da'asnu	$c_1$ (mass normally, but 1 individual/jo'u possible) argues/quarrels about topic/subject $c_2=d_3$ with opponent $x_3=d_2$.
soıpıu	dabycalku	$c_1$ is armor around $c_2$ composed of $c_3$ against opponent $x_4=d_2$.
soısıufaq	dabysmifau	$f_1$ (event) is a wargame, simulating combat by $d_1$ against $d_2$ over issue $d_3$ (abstract).
beaıtua	dadgau	$g_1$ hangs/suspends $d_1$ from $d_2$ with/by means  $d_3$.
beaıboafuq	dadne'ota'u	$t_1$ is a necktie for wearing by $t_2=c_2$ serving purpose $t_3$.
beaınhoqteı	dadyskotai	$x_1$ is a catenary (ideal shape) of form $x_2$
tıeqchualaı	dagme'esni	$s_1$ is a road sign representing a/the name $s_2=c_1$ of road/street $c_2=d_1$—name given by $c_3$—to observer $s_3$.
tıeqjeoq	dagyke'a	$k_1$ is a pothole in road $d_1=k_2$.
tıeqchoq	dagypli	$p_1$ (person) is a road user using road/highway/street/path/(square) $d_1=p_2$ for purpose $p_3$.
tıeqrem	dagysfe	$s_1$ is pavement of road/highway $x_2=d_1$.
tıeqlaı	dagysni	$s_1$ is a road sign meaning $s_2$ to observer/driver/pedestrian $s_3$.
nıaıguq	dalcnita	$c_1$ is ventrally oriented/is placed ventral relative to $c_2$ of animal $d_1=c_3$
nıaıshaq	dalcrane	$c_1$ is anterior oriented/is rostral relative to $c_2$ of animal $d_1=c_3$
nıaıgao	dalgapru	$g_1$ is dorsally oriented/is placed dorsal relative to $g_2$ of animal $d_1=g_3$
nıaıme	dalgunma	$x_1$ is a flock/pride/herd of animals $x_2$
nıaıchao	dalma'e	$x_1=m_1=d_1$ is a steed or mount of species $x_2=d_2$, ridden by $x_3=m_2$ on or in surface/terrain/medium $x_4=m_3$
nıaıpaı	dalpe'o	$p_1=d_1$ is a pet belonging to $p_2$ of species $d_2$.
nıaıpaıhaq	dalpe'odja	$c_1$ is pet food for pet $c_2=d_1=p_1$.
nıaıreqcho	dalremnei	$x_1=n_1=r_1$ is a furry/kemono/anthro fan of species/fursona $x_2=d_2$
nıaıtıa	daltrixe	$t_1$ is posterior /is placed caudal relative to $t_2$ of animal/species $d_1=g_3$
nıaıpoaıcıu	daltsivi'i	$x_1$ pushes out, lays egg $x_2$.
maraotue	dansycu'u	$c_1$ is a dance/ball involving participants $c_2=d_1$, to accompaniment/music/rhythm $d_2$.
maraoteı	dansytai	$x_1$ is a choreography / type of dance, danced by $x_2$ to music $x_3$
jaohıe	darbei	$b_1$ carries/hauls/bears/transports cargo $b_2$ far away to $b_3=d_1$ from $b_4=d_2$ over path $b_5$.
jaohıe	darbevri	$b_1$ carries/hauls/bears/transports cargo $b_2$ far away to $b_3=d_1$ from $b_4=d_2$ over path $b_5$.
jaokaqsıchuo	darctatci	$t_1$ is a telescope for examining $c_2=d_1$ which is far from $d_2$.
jaoduı	dardu'e	$du_1=da_1$ is too far/distant from $da_2$ in property $da_3$ (ka) by the standard of $du_3$.
jaotua	dargau	$x_1=g_1$ removes $x_2=d_1$ from $x_3=d_2$ in property $x_4=d_3$ (ka); $x_1$ puts distance between $x_2$ and $x_3$ in property $x_4$.
jaojıeq	darji'o	$j_1=d_1$ is the end of $j_2$ at $j_3$ far from $d_2$
jaoloma	darpi'e	$p_1$ long jumps to $p_2$ from $p_3$ reaching height $p_4$.
jaocaq	dartro	$x_1$ remotely controls $x_2$ in state/enterprise $x_3$
jaocaqchuo	dartrotci	$x_1$ is a remote control for controlling $x_2$ in event/state/enterprise $x_3$
jaoshıaq	dartu'e	$x_1$ is the shin/calf (body-part) of $x_2$
jaokaq	darvi'a	$v_1$ sees/views/perceives visually $v_2=d_1$, which is far away, under conditions $v_3$
jaokaqchuo	darvistci	$t_1$ is a telescope for seeing $v_2=d_1$ which is far from $d_2$.
heochua	datcme	$c_1=d_1$ is an alias/nickname of $c_2$ used by $c_3$ instead of name $d_2$, differing from it by standard $d_3$.
daodao	datnydatni	$x_1$ (du'u) [fact or facts] is metadata / data about data [content] $x_2$ (du'u). The data (of $x_1$, that is) is gathered by method $x_3$.
daojuo	datnynoi	$n_1=d_1$ is a report about $n_2=d_2$ from reporter $n_3$ to intended audience $n_4$.
daogıa	datnysri	$x_1=das_1$ is a signal recording and playback tape-type medium (cassette/DAT/tape drive) containing data/sound/image $x_2=dat_1$ with data storage mechanism/method $x_3$ (analog/digital)
daoheq	datnyvau	$v_1$ is a computer variable/register/memory cell with contents $v_2=d_1$.
daoheqme	datnyvaugunma	$g_1$ is computer memory, consisting of parts $x_2=g_2=v_1$.
daoreaq	datnyvei	$x_1=v_1$ is a file consisting of information $x_2=d_1=v_2$ about $x_3=d_2=v_3$ in medium $x_4=v_4$.
daoreaqlıaq	datnyveimei	$x_1$ is a folder of files $x_2$.
heohuıjaı	datxlagei	$x_1$ is happy about $x_2$, which is bad for $x_3$ by standard $x_4$, the sufferer differing from the enjoyer by standard $x_5$.
deatoe	daxyka'a	$x_1$ chops $x_2$ into pieces $x_3$.
cheınıaı	degda'u	$x_1$ is a tetrapod animal
cheıpıu	degycalku	$c_1$ is a fingernail/toenail of finger/toe $c_2=d_1$ on limb/body site $d_2$ of body $d_3$.
cheılaı	degysni	$d_3$ points at $s_2$ so that $s_3$ will notice it.
nıoqrıe	denbi'i	$x_1=j_1$ is interdental/between the upper and lower teeth of body/person $d_2$
nıoqnoı	dencro	$c_1=d_2$ has a toothache in tooth $d_1=c_2$.
nıoqcıe	denfi'e	$x_1$ is a piranha of species $x_2$ with teeth $x_3$
nıoqjeoq	denke'a	$x_1=k_1$ is a tooth cavity/dental caries [demineralized site] of tooth $x_2=k_2=d_1$
nıoqrıe	densru	$x_1$ is the gum/cementum of animal $x_2$.
laomoe	depcni	$c_1$ feels patience about $c_3$.
laokua	depkumfa	$k_1$ is a waiting room/break room in structure $x_2$ surrounded by partitions/walls/ceiling/floor $x_3$ (mass/jo'u).
laoca	depri'a	$x_1$ causes $x_2$ to wait for $x_3$ at $x_4$ before continuing $x_5$.
laolaq	depsna	$s_1$ is a hesitation sound produced by $s_2=d_1$ while for/until $d_2$ at state $d_3$ before starting/continuing $d_4$ (activity/process).
laorıaq	depstu	$s_1$ is a waiting room/place where $d_1$ waits for $d_2$.
laochue	depypoi	$p_1$ is a waiting queue ordered by rules $p_2$ on unordered set $p_3$ waiting for $x_4=d_2$.
asaıchaq	derdei	$x_1$ is Saturday of week $x_2$ on calendar $x_3$.
asaıjıu	derjbe	$j_1$ sprouts from $x_2=d_1$.
asaıguq	derni'a	$x_{1}$ is a beneath with has underneath-dirt $x_{2}$.
asaıguqtua	derni'agau	$x_{1}$ is a do with beneath $x_{2}$ with has underneath-dirt $x_{3}$.
asaıdıu	derske	$s_1=d_1$ is soil science [science about earth/soil] based on methodology $s_3$.
ceoqhıu	dicfle	$f_1=d_1$ is an electrical current / flow in / on / through $f_2 = d_2$ flowing in direction to / towards $f_3$ from direction/source $f_4$.
ceoqhıushoe	dicflecru	$c_1$ is a transistor / electrical regulator which allows electric current $c_2 = df_1$ to flow under conditions $c_3$ in / on / through $df_2$ flowing in direction to / towards $df_3$ from direction/source $df_4$.
ceoqjuodıeqbeaq	dicnoibejga'a	$g_1$ is a telegraph pole.
ceoqchue	dicre'e	$t_1$ is an electric train [vehicle] of cars/units $t_2$ (mass) for rails/system/railroad $t_3$, propelled by electric motors/systems $t_4$
ceoqcıa	dicycau	$d_1=c_1$ is electrically uncharged.
ceoqjıeq	dicyji'o	$x_1=j_1$ is an electrode of circuit/electric machinery/electronic component $x_2=j_2$ at locus $x_3=j_3$
jıome	dijgunma	$x_1=g_1$ is a complex composed of buildings $x_2=g_2=d_1$ for purpose $x_3=d_2$
jıoshaq	dijycra	$x_1=c_1$ is the façade of building $x_2=c_2=d_1$ which faces/in-frame-of-reference $x_3=c_3$
jıobaıdıu	dijyzbaske	$s_2$ is architecture.
nuaıtue	dincu'u	$c_1$ is a monetary affair involving $c_2$
nuaısıao	dinkra	$x1$ is a fund of $x2$
nuaıraq	dinra'a	$x_1$ is related to money; $x_1$ is monetary, fiscal, financial (personal or otherwise), pecuniary.
nuaıcaqtue	dintrocu'u	$c_1$ is a/the financial management function/activities involving persons $c_2=ji_1$, of money/currency issued by $jd_2$; $c_1$ is finance.
nuaıreaq	dinvei	$x_1$ is a financial record of $x_2$ (data/facts/du'u) regarding financial entity $x_3$ preserved in medium $x_4$
nuaıreaqtue	dinveicu'u	$c_1$ is an/the accounting function/activities involving persons $c_2$, using currency issued by $j_2$, recording $v_2$  (data/facts/du'u) about $v_3$ (object/event); $c_1$ is accounting.
haqhıe	djabei	$b_1$ is a waiter, carrying food $c_1=b_2$ to $b_3$ from $b_4$ over path $b_5$.
haqhıepoq	djabeipre	$p_1=b_1$ is a waitress/waiter serving food $b_2=c_1$ to $x_3=c_2=b_3$.
haqcıamuoq	djacaumro	$m_1=c_2$ starves to death from lack of food/nutrition $c_1$
haqshuao	djacpi	$cip_1=cid_1$ is an edible bird of species $cip_2$.
haqleu	djalitki	$x_1$ is a beverage consisting of $x_2$
haqtıaı	djata'e	$x_1=t_1$ is a lunch/bento (portable) box/carrier containing food $x_2=c_1=t_2$, and made of material $x_3=t_3$
shaocaı	djicai	$x_1=d_1=c_1$ intensely desires/craves/[needs] $x_2=d_2$ for purpose $x_3=d_3$ as seen/observed/measured by $x_4=c_3$.
shaorutua	djijevgau	$x_1$ (agent)'s action results in the intended result $x_2$
shaorutua	djijvegau	$x_1$ (agent)'s action results in the intended result $x_2$
shaokuq	djisku	$x_1$ expresses/says that they desire $x_2$ (nu/ka) to audience $x_3$ in medium $x_4$, desired for purpose $x_5$
soajaı	djugei	$x_1=g_1=s_1$ is happy/merry/gay about helping/assisting/aiding object/person $x_2=s_2$ to do/achieve/maintain event/activity $x_3=s_3$
soasıao	djukra	$x1=k1=d1$ is a resource for $x2=d2$ to use
soajuo	djunoi	$n_1$ is an instruction/advice from $x_2=n_3$ to help/assist/aid $x_3=s_2=n_4$ do/achieve/maintain event/activity $x_4=s_3$.
soacheo	djusi'u	$x_1$ (plural) help each other doing $x_2$
soakuq	djusku	$c_1=s_1$ gives advice $c_2$ (sedu'u/text/lu'e concept) to $c_3=s_2$ about doing/achieving/maintaining $s_3$, on medium $c_4$.
dıonuaq	dorcte	$x_{1}$ is the calendar day of event $x_{2}$ at location $x_{3}$
dıochuq	dorcti	$x_1$ lunches on lunch $x_2$
duebeo	draga'i	$g_1$ (event) corrects $g_2$ into $g_3=d_1$, correct in property/aspect $x_4=d_2$ (ka) in situation $x_5=d_3$ by standard $x_6=d_4$.
duebeotua	draga'igau	$x_{1}$ is a do with modify $x_{2}$ with changed $x_{3}$ with modified into-correct $x_{4}$ with correctness $x_{5}$ with correctness situation $x_{6}$ with correctness standard $x_{7}$.
duetua	dragau	$g_1$ (person/agent) corrects $d_1$.
meotua	drigau	$x_1$ (agent) makes $x_2$ sad about $x_3$ (abstraction)
meojaı	drigei	$x_1$ feels bittersweet about $x_2$ (event/state)
dochua	du'acme	$c_1=d_2$ (quoted word(s)) is the given name (as opposed to the family name) of $c_2=d_3$, used by $c_3$ and given by namer $d_1$.
duıshao	du'edji	$x_1=du_1=dj_1$ is greedy for/wants too much of $x_2=dj_2$ (event/state) for purpose $x_3=dj_3$, excessively greedy by standard $x_4=du_3$.
duıjuoı	du'eski	$x_1=s_1$ exaggerates $x_2=s_2$ (object/event/state) to audience $x_3=s_3$ with description $x_4=s_4$ (property)
jeqdua	dubju'o	$x_1$ recognizes/knows identity of $x_2$ by epistemology $x_3$
jeqrıoq	dunlei	$x_1$ is an equivalence class within $x_2$ defined by equivalence relation $x_3$.
jeqcheo	dunsi'u	$x_1=s_1=d_1=d_2$ (set) are equivalent in quantity $x_2=d_3$ (ni).
duılıe	dusfri	$x_1$ is satiated/overwhelmed by $x_2$ with property $x_3$ by standard $x_4$; $x_2$ is too much for $x_1$ in property $x_3$ by standard $x_4$.
koıshuao	dzucpi	$x_1 = d_1 = c_1$ is a member of the class of birds which walk/run/hop as their characteristic/primary form of locomotion, of species/taxon $x_2 = c_2$
koıtıeqchoq	dzudagypli	$c_1=p_1$ is a pedestrian walking on road/path/surface $c_2=d_1=p_2$.
koıchue	dzupoi	$p_1$ is a procession with participation ordered/sequenced by rules $p_2$.
loechaq	fagdei	$x_1$ is Tuesday of week $x_2$ on calendar $x_3$.
loeca	fagri'a	$r_1$ kindles $f_2$ in atmosphere $f_3$ under conditions $r_3$
loejıaoloha	fagycevjinme	$x_1$ is a quantity of/contains/is made of promethium [Pm]
loeceochuo	fagycfatci	$x_1$ is a tool for starting fire $x_2$. $x_1$ is a lighter such as for cigarettes.
loefaq	fagyfau	$x_1$ is an incident/a disaster of fire
loemute	fagyfesti	$x_1=fe_1$ is the ashes of $x_3=fa_2$, combusted by fire $x_2=fa_1$.
loemutereo	fagyfesyska	$s_1$ is/appears to be of ash color/hue as perceived/seen by $x_2=s_3$ under conditions $x_3=s_4$.
loeshaıtua	fagystigau	$g_1$ extinguishes/puts out fire $x_2=s_1=f_1$.
loebua	fagzda	$z_1$ is a fireplace/hearth for fuel $f_2$ burning in/reacting with oxidizer $f_3$ (default air/oxygen).
shuagueq	falbu'u	$b_1$ is a parachute of type/material $b_2$.
shuatua	falgau	$g_1$ makes $f_1$ fall.
shuaguqshoemfa	falni'ajirkla	$k_1=j_1=c_1=f_1$ drift dives to destination $k_2=f_2$ from origin $k_3=f_3$ in drifting frame of reference $f_4$, via route $k_4$ using means/vehicle $k_5$ in  liquid $j_2$ beneath/under/down from $c_2$ (object/water surface) in downward frame of reference $c_3$.
shuapıanete	falplini	$f_1=p_1$ is a meteor which falls to planet $p_2$ from area/planet $f_3$ with composition $p_3$
shuaca	falri'a	$r_1$ (event/state) is the cause of that $f_1$ falls/drops to $f_2$ from $f_3$ in gravity well/frame of reference $f_4$; under conditions $r_3$.
faobudeq	famnalka'e	$k_1$ is not able to end $k_2$ (event/state) under conditions $k_3$ (event/state).
faokuq	famsku	$c_1$ (agent) concludes by expressing/saying $c_2=f_1$ for/to audience $c_3$ via expressive medium $c_4$ concluding $f_2$.
faorıaq	famstu	$x_1$ is a place where $x_2$ (event) ends
feogıam	farmu'u	$x_1$ moves towards $x_2$ from direction $x_3$
feolaı	farsni	$s_1=f_3$ non-agentively/inanimately points at/indicates the direction of $s_2=f_2$ to observer $s_3$ as being in the direction $f_1$.
feoruo	fartra	$x_1$ treats $x_2$ in way $x_3$ (ka)
faqbeo	faucne	$x_1$ (event) varies in intensity/amount
faqtuao	faumli	$x_1$ (event) happens mildly/non-extremely/gently/somewhat
faqdu	faumlu	$x_1$ (event) seems to happen/take place to observer $x_2$
faqduı	faurdu'e	the amount/intensity of event/state $x_1$ is too high for $x_2$ to happen; $x_1$ happens too much for $x_2$ to happen
faqsuaı	faursutra	$f_1=s_1$ (event) happens swiftly/quickly/rapidly
faqdaq	faurtei	$f_1$ is an event that has time/temporal duration $t_1$ ranging from starting time/event $t_2$ to ending time/event $t_3$.
faqjeaq	faurze'a	$x_1$ (event) increases in intensity/amount
faqjaq	fautce	$x_1$ (event) happens intensely/in a great degree
feıshoı	fe'ucmo	$c_1=f_1$ growls/snarls/roars c2 [non-linguistic utterance] in anger at $f_2$ for $f_3$ (action/state/property).
feıtuao	fegmli	$m_1=f_1$ is irritated/[mildly angry] at $f_2$ for $f_3$ (action/state/property)
feıtuaochoa	fegmliba'u	$m_1=f_1=b_1$ grumbles with sound $b_2$ at $f_2$ because of $f_3$ (action/state/property).
feıca	fegri'a	$r_1$ (event) angers $f_1$.
feıcıa	fegycau	$f_1=c_1$ is without anger/mild/meek regarding $f_2$ for $f_3$ (action/state/property).
feıtua	fegygau	$x_1$ makes $x_2$ angry / mad at $x_3$ for $x_4$ (action / state / property); $x_1$ angers / provokes / stirs up $x_2$.
mutejeoqtıeq	feskevlu'a	$x_1$ is a sewer carrying waste through $x_2$ that stretches from $x_3$ to $x_4$ and goes through points $x_5$ (set)
mutetıshaı	fesli'a	$x_1=f_2=c_1$ abandons / forsakes / leaves behind $x_2=f_1=c_2$
mutechoq	fespli	$x_1$ recycles $x_2$ for new purpose $x_3$.
mutetua	fesygau	$x_1=g_1$ [person/agent] leaves waste product/wastes $x_2=f_1$ by event/activity $x_3=f_2=g_2$
mutepoetua	fesyseigau	$x_1$ removes waste/trash $x_2$ from $x_3$.
mutedıu	fesyske	$s_1$ is garbology based on methology $s_3$.
muterıaq	fesystu	$x_1$ is a landfill or other area where refuses/garbages are disposed of.
lıqbuseo	fetnalspe	$f_1=n_1$ is an unmarried woman under law/custom/tradition $s_3$.
lıqjaqsao	fetytcebra	$f_1=b_1=m_1$ is a huge/enormous/very big female being in property/dimensions $b_2$ as compared with standard/norm $b_3$. $f_1=m_1=b_1$ is a giantess.
afarıdueq	fi'ortu'a	$f_1=t_1$ is Africa.
luakue	fikcku	$cu_1=cf_1$ is a fictional book about plot/theme/subject $cf_1$ by author $cu_3=cf_3$ for audience $cu_4$ preserved in medium $cu_5$.
fuıtua	filgau	$g_1$ [person/agent] causes $f_1$ to be easy for $f_2$ under condition(s) $f_3$.
fuıca	filri'a	$r_1$ [event/state] causes $f_1$ to be easy for $f_2$ under condition(s) $f_3$.
fuımıu	filsmu	$s_1$ is easily understood/interpreted as the meaning of $s_2$ by (agent) $s_3=f_2$ under conditions $f_3$
fuıkeoı	filta'a	$t_1=f_2$ speaks fluently to $t_2$ about subject $t_3$ in language $t_4$ under conditions $f_3$.
fıeqjıao	fincei	$c_1=f_1$ is the creator deity/demiurge of people(s)/religion(s) $c_2$, having created $c_3=f_2$ from material/primordial chaos $f_4$.
fıeqcueq	fingubni	$x_1$ is free and open source (not limited to software)
fıeqıq	finkai	$c_1$ is characterized by creativity; $c_1$ is creative/inventive (one sense).
fıeqruo	fintra	$t_2$ is the style (in the sense of art/fashion/creative work/object) of object $f_2$ by creator $f_3$ derived from existing elements/ideas $f_4$
cıejue	fipma'i	$x_1$ is March of year $x_2$ in calendar $x_3$.
cıenueqbeaq	fipre'uga'a	$x_1$ is stick-shaped fish meat [a fishstick] of fish type/species $x_2$
cıegıe	fipybirka	$b_1$ is a fin of fish $x_2=f_1$ of species $x_3=f_2$.
cıekuoq	fipybo'u	$b_1$ is a fish bone, performing function $b_2$ in body of fish $b_3$.
juaocıa	flacau	$c_1=f_3$ [lacks law]/[is lawless with regard to] law(s) $f_1$ specifying $f_2$ (state/event) under conditions $f_4$ by lawgiver(s) $f_5$; $c_1=f_3$ is lawless.
juaoceocueme	flacfatrugri	$g_1=t_1$ is the Lower House/House of Representatives/House of Commons for territory $t_2$ with members $g_3=f_5$.
juaodoeme	flaci'e	$f_1$ is the legal system concerning topic $f_2$ in society $f_3$
juaosoa	fladju	$x_1$ is a lawyer
juaojıebua	flapaizda	$z_1$ is a judicial court administering lawsuit $p_2=f_2$ for community $f_3$.
juaobo	flapo'e	$p_1$ legally owns / is the legal owner of $p_2$ according to law $p_3=f_1$.
juaoca	flari'a	$r_1=f_5$ enacts $r_2=f_1$ (law/legislation/treaties/act) for community $f_3$ under condition $r_3=f_4$.
juaocuedoeme	flatruci'e	$c_1=t_1=f_5$ is the legislative branch of the government of people/territory/domain/subjects $t_2$.
juaobua	flaxa'u	$x_1$ is a/are legal resident(s) of location/country $x_2$ according to law $f_1$ specifying $f_2$ (state/event) for community $f_3$.
hıuruq	flecarvi	$c_1$ pours/intensely rains to $c_2$ from $c_3$.
hıushua	flefa'u	$x_1$ is a fluid or fluid-like pouring to $x_2$ from $x_3$.
hıufaobıu	flefamtu'u	$x_1$ is a faucet made of material $x_2$ with flow rate $x_3$ and water pressure $x_4$
hıucaqkea	fletroca'a	$x_1$ is a valve, a device that controls the flow of $x_2$ through a pipe $x_3$
hıucaqgıokea	fletrogusmi'i	$x_1$ is a traffic light
hıubıu	fletu'u	$x_1=t_1$ is a pipe/tube/hose carrying fluid $x_2=f_2=t_3$ towards $x_3=f_3$ from $x_4=f_4$ (direction/source)
buaqrıu	flixru	$x_1$ bounces $x_2$ back to $x_3$ from $x_4$ because of failure $x_5$.
buaqtao	flizu'e	$x_1=z_1=f_1$ does $x_2=z_2$ to achieve goal $x_3=z_3=f_2$ which $x_1$ fails to achieve.
lıecıatea	fricaute'a	$x_1=t_1$ feels FOMO ("fear of missing out") about $x_2=t_2$; $x_1=t_1$ is scared of missing out on event/experience/information $x_2=t_2$
lıeshaokuq	fridjisku	$c_1=d_1$ expresses wish to audience $c_3=l_1$ that he/she/it/they experience $l_2$, via expressive medium $c_4$
lıetua	frigau	$x_1$ makes $x_2$ undergo experience $x_3$; $x_1$ treats $x_2$ in manner $x_3$.
afarıdueq	frikytu'a	$f_1=t_1$ is Africa
lıedıu	friske	$s_1$ is phenomenology of/about (aspect of) phenomena/perception/conscious experience $s_2$ (subject matter), with methodology $s_3$.
kopıtoa	fu'ivla	$x_1=v_1=f_1$ is a loanword meaning $x_2=v_2$ in language $x_3=v_3$, based on word $x_4=f_2$ in language $x_5$.
kopılaqshuao	fuksnacpi	$c_1=s_2$ is a mockingbird of species $c_2$ which produces sound $s_1$ that is a copy of $f_2$.
kopıtua	fukygau	$g_1$ (agent) creates copy $f_1$ of $f_2$ in form/medium $f_3$ by method $f_4$ (event).
kopısheıbo	fukyzifpo'e	$f_1=z_1=p_1$ holds the copyright for copying $f_2=p_2$ under law $p_3$.
beaqmarao	ga'ardansu	$d_1$ (individual, mass) pole dances to accompaniment/music/rhythm $d_2$ using pole $g_1$.
beaqkıao	ga'avro	$v_1$ is a grate between $v_2$ and $v_3$ of material $g_2=x_4$.
gaısı	ga'ezga	$g_1=z_1$ perceives $z_2$ to have quality $g_2$ by means/sense $g_3=z_3$ under conditions $g_4=z_4$
geagıe	galbirka	$g_1=b_1$ is a forearm of $b_2$.
geakaqsı	galcatlu	$c_1$ looks up at $c_2=g_1$.
geatua	galgau	$gas_1$ elevates/raises $gal_1$ by height reference $gal_2$ and height standard $gal_3$.
geajıeq	galji'o	$g_1=j_1$ is the peak/summit of $j_2$ at location $j_3$ in frame of reference $g_2$
geagıam	galmu'u	$m_1$ rises to $m_2=g_1$ from origin $m_3=g_3$ via path $m_4$.
geashıaqshaq	galtupcra	$c_1=g_1$ is the lap of $t_2$.
gaıfuı	gasfrili	$x_1$ is obvious/easy to notice for $x_2$
gaıkıaq	gaskre	 $k_1=g_3$ is a/are the whisker(s)/sensory hair(s) /vibrissa(e) attached to $k_2=g_1$ at body part $k_3$ for the detection of stimuli $g_2$ under conditions $g_4$.
gaıcheu	gastcica	$x_1$ (event) is an illusion that deceives/tricks $x_2$ into sensing $x_3$ using sense $x_4$ under conditions x5
tuachoq	gaupli	$x_1$ uses $x_2$ for bringing about $x_3$ (event)
tuatao	gaurzu'e	$x_1$ volitionally brings about $x_2$ (event) for purpose/goal $x_3$ (event)
kunebua	ge'urzdani	$z_1$ is a doghouse for dog $z_2=g_1$.
kunebua	ge'uzda	$z_1$ is a doghouse for dog $z_2=g_1$.
zujuaogıqdue	gentoldra	$x_1$ is grammatically incorrect in situation $x_2$ according to grammar $x_3$
zujuaotoatoaı	genvlasle	$s_1=g_1$ is a morpheme/most basic grammatical subunit of word, meaning/causing $v_2$ in language $v_3=g_2$ for language/text $g_3$.
kuneshoı	gercmo	$x_1=c_1=g_1$ barks expressing  $x_2=c_3$.
kunehaq	gerdja	$c_1$ is dog food for dogs $c_2=g_1$.
kunebua	gerkyzda	$z_1$ is a doghouse for dog $z_2=g_1$.
kunebua	gerkyzdani	$z_1$ is a doghouse for dog $z_2=g_1$.
kunedıu	gerske	$s_1$ (mass of facts) is cynology/science about dogs $g_1=s_2$ based on methodology $s_3$.
kunenueq	geryre'u	$r_1$ is dog meat from species/breed $r_2=g_2$.
kunebua	gerzda	$z_1$ is a doghouse for dog $z_2=g_1$.
kunebua	gerzdani	$z_1$ is a doghouse for dog $z_2=g_1$.
loqtua	glagau	$x_{1}$ is a do with hot $x_{2}$ with hot standard $x_{3}$.
loqnoaıkafe	glaladyckafi	$c_1$ is a quantity of café au lait/latte/café con leche/cappuccino/flat white/coffee with heated dairy [or similar] product/creamer/whitener $la_1=g_1$, addition warm by standard $g_2$.
loqmıeq	glamre	$m_1$ is a temperature measurer measuring the temperature of object $m_2=g_1$ as $m_3$ units on scale $m_4$ with accuracy $m_5$
loqmıeqchuo	glamretci	$t_1$ is a thermometer used for measuring temperature $m_2=g_1$ as $m_3$ units on scale $m_4$ with accuracy $m_5$
loqcaqchuo	glatrotci	$x_1$ is a heating regulator
seaqshao	gledji	$x_1=g_1=d_1$ desires sexual activity $x_3=d_2$ with participants $x_2=g_2$ for purpose $x_4=d_3$
seaqgaq	glekansa	$x_1$ together with $x_2$ has sex with $x_3$
seaqgaqcheo	glekansi'u	$x_1$ (group) has sex with $x_2$
seaqchuo	gletci	$t_1$ is a tool/toy/instrument used for sex.
seaqcaq	gletro	$x_{1}$ is a control-copulate with controlled-copulated with $x_{2}$.
seaqcıu	glevi'i	$v_1$ (body) ejaculates $v_2$ from source $v_3$ via means/route $v_4$.
ıqlızujuao	glige'a	$ge_1$ is English grammar for structure/text $ge_2$.
ıqlııqlızu	gliglibau	$g_1=b_1$ is the British English language, used by $b_2$ to express/communicate $b_3$ (si'o/du'u, not quote).
ıqlıguo	gligu'e	$gu_1$ is England (country).
ıqlıguo	gligugde	$x_1$ is an England of peoples $x_2$ with territory $x_3$, being English in aspect $x_4$.
ıqlıpoq	glipre	$x_1$ is an English person / is a person that shows traits $x_2$ related to England / English culture.
peodıeq	grebe'i	$b_1$ ferries $b_2=p_1$ to $b_3=p_3$ from $b_4=p_4$ over barrier/medium/portal $b_5=p_2$.
peomeaq	greblo	$b_1$ is a ferry boat for carrying $b_2$ over barrier/medium/portal $x_3=p_2$ to destination $x_4=p_3$ from origin $x_5=p_4$.
peotua	gregau	$g_1$ makes $x_2=p_1$ pass through $x_3=p_2$ to destination side $x_4=p_3$ from origin side $x_5=p_4$.
peojeoq	greke'a	$x_1=k_1$ is a hole in $x_2=k_2=p_2$ to/between $x_3=p_3$ from/and $x_4=p_4$ permitting passage by $x_5=p_1$.
peofa	grekla	$x_1=p_1=k_1$ passes through portal/generically exits or enters via portal (entrance/exit) $x_2=p_2$ to destination side $x_3=p_3=k_2$ from origin side $x_4=p_4=k_3$ via route $x_5=k_4$ using means/vehicle $x_6=k_5$.
gıosuaı	gu'irsutra	$s_1$ is quick-as-light at doing $s_2$
cueqduatua	gubjungau	$j_1$ advertises $jg_3=g_1$ (du'u) to $jg_2=g_2$ (mass) about subject $jg_4$.
cueqjuo	gubnoi	$g_1=n_1$ is an advertisement about subject $n_2$ from author $n_3$ to audience $g_2=n_4$.
cueqkuq	gubnysku	$x_1$ announces, proclaims $x_2$ (text, assertion) towards $x_3$
cueqkoe	gubycu'a	$c_1$ votes (in a public election) for $c_2$ among choices $c_3$ in electorate $g_2$.
cueqkuq	gubysku	$x_1$ announces, proclaims $x_2$ (text, assertion) towards $x_3$
cueqtao	gubzu'e	$x_1$ publicizes / promotes $x_2$ (product or idea) to community $x_3$
guojoaq	gugja'a	$j_1$ is the president of people $g_2$ in country $g_3$.
guocoedoeme	gugjonci'e	$c_1$ is a supranational union of member states $g_1=j_1=c_3$
guogıam	gugmu'u	$x_1$ migrates to country $x_2$ from country $x_3$ over path/route $x_4$.
guochıeq	gugykruca	A citizen $x_1=g_2=k_1$ is international in aspect/participates in an international event $x_2=k_3$.
guopaq	gugypau	$p_1$ is a state/province/region (first-level administrative division) of country $p_2=g_1$.
guopaqtoaı	gugypausle	$s_1$ is a county/district/parish/province (second-level administrative division) of country $s_2=g_1$.
mesoı	gumda'a	$x_1$(mass) brawls with $x_2$(mass) over issue $x_3$ (abstract)
metua	gumgau	$ga_1$ combines individual $gu_2$ into mass $gu_1$.
meguo	gumgu'e	$gun_1=gug_1$ is a federative state consisting of states/lands $gun_2$
menao	gumjau	$d_1=g_1$ is a pool of water.
meshuaq	gumpra	$x_1$ mass produces $x_2$ [product] by process $x_3$
guaılıereaq	gunfrivei	$x_1$ is a résumé / cv / curriculum vita, summarizing $x_2$'s work experience, in medium $x_3$.
guaıcuesıo	guntrusi'o	$s_1$ is a communist ideology (default: Marxist-Leninist) as it applies to the governance of  people/territory/domain $t_2$ based on the works of thinker(s) $s_3$
gıotoaı	guska'u	$x_1$ is a photon.
gıogıu	gusli'i	$x1=l1$ is a ray/beam/[line of light] illuminating $x2=g2$ from source $x3=g3$
gıochuo	gustci	$x_1$ is a lamp
gıosho	gusybi'o	$b_1=g_1$ brightens under conditions $x_2=b_3$.
gıocaı	gusycai	$x_{1}$ gleams/shines on to $x_{2}$, the light source being $x_{3}$.
gıoshoem	gusyjinru	$x_1$ basks in light $x_2$.
gıosuaıgıam	gusysutmu'u	$x1=s1=m1$ flashes to $x2=m2$ from $x3=m3$ via $x4=m4$
naoshuarıaq	jacfalstu	$x_1$ is a waterfall
naorıa	jackalri	$x1$ is a hydrant
naojeoqtıeq	jackevlu'a	$x_1$ is a culvert under $x_2$ stretches from $x_3$ to $x_4$ and goes through points $x_5$
naotıeq	jaclu'a	$p_1$ is a waterway to $p_2$ from $p_3$ via/defined by points including $p_4$ (set).
naomajı	jacmakfa	$x_1=m_1$ is water magic as observed by $x_2=m_2$, performed by person/force/deity $x_3=m_3$.
naoruanıu	jacrulspa	$s_1$ is a water lily (genus Nymphaea) of species/strain $s_2$ with flower $x_1$.
naotoq	jacta'o	$t_1=d_1$ is a board for use in water/(wind/kite)surfingboard/bodyboard/wakeboard of material/property $t_2$.
naokıao	jacyvro	$x_1=v_1$ is a floodgate/stop gate between $x_2=v_2=d_1$ and $x_3=v_3$ of structure $x_4=v_4$
jıaımuq	jairxa'e	$x_{1}$ is a hand-grasping appendage with has hand-grasp $x_{2}$.
jıaıchuo	jaitci	$x_1=t_1=j_4$ is a handle to hold/grasp/carry $x_2=j_2$ used by $x_3=j_1$
soımeaq	jamblo	$b_1$ is a warship of type/carrying $b_2$, propelled by $b_3$.
soıcheı	jamdegji	$j_1=d_1$ is a toe of $j_2=d_2$.
soıchao	jamkarce	$k_1$ is an armoured fighting vehicle/AFV propelled by $k_3$.
soırıaq	jamstu	$x_1$ is a battlefield
soıtıa	jamti'e	$t_1$ is a heel of $j_2$.
naochaq	jaudje	$x_1$ is Wednesday of week $x_2$ on calendar $x_3$.
naohıejue	jaurbeima'i	$x_1$ is February of year $x_2$ in calendar $x_3$.
naoruq	jaurcarvi	$c_1=b_1$ (some water) rains to $c_2$ from $c_3$.
naochaq	jaurdei	$x_1$ is Wednesday of week $x_2$ on calendar $x_3$.
naohıuheq	jaurflevau	$v_1$ is a pipe carrying $v_2=f_2$ to $f_3$ from $f_4$
naomıe	jaurji'e	$x_1=jm_1$ is an organism living in water $x_2=dj_1$
naomıetıaı	jaurji'eta'e	$x_1=t_1$ is an aquarium(container for aquatic beings)/fish tank for $x_2=t_2=jm_1$
naoremmeaq	jaursfeblo	$x_1$ is an aquatic boat/ship/vessel for carrying $x_2$, propelled by $x_3$.
naoheqmuoq	jaurvasmro	$m_1$ drowns in body of water $d_1$.
naosıoqkea	jaurxilmi'i	$m_1$ is a water wheel for use/function $m_2$.
jıuguo	jbegu'e	$x_1$ is the birth country of $x_2$ // $x_1$ is the country where $x_2$ was born
jıudaq	jbetei	$x_1$ (amount of time) is the age of $x_2$.
juısho	jbibi'o	$b_1=j_1$ approaches/nears/draws nearer/closes in on $j_2$.
juıtua	jbigau	$g_1$ makes  $j_1$ close to/approximate  $j_2$ in property/quantity $j_3$ (ka/ni).
juıjıeq	jbiji'o	$jip_1=jib_1$ is the end of $jip_2$ at $jip_3$ near to $jib_2$
juırıalaq	jbikarsna	$s_1$ is a semivowel sound.
juıpu	jbipru	$x_1$ is recent/is in the recent past/is in the near past of $x_2$.
juıbua	jbixa'u	$x_1$ is a neighbor of / lives close to / lives near to $x_2$
lojıbaqchoakeoı	jboba'usnu	$c_1=b_1$ converses orally in Lojban about subject $c_2$ using sound/expression $l_1=b_2$.
lojıbaqzu	jbobau	$l_1=b_1$ is Lojban used by $b_2$ to express/communicate $b_3$ (si'o/du'u, not quote).
lojıbaqzudıu	jbobauske	$x_1=s_1$ is the science/study of the Lojban/Lojbanic language based on methodology $x_2=s_3$.
lojıbaqzusıu	jbobausmi	$s_1$ is similar/parallel to Lojban in property $s_3$ (ka).
lojıbaqjoe	jbocre	$x1$ is an expert in Lojban language.
lojıbaqcıe	jbofi'e	$l_1$ is Jbofihe.
lojıbaqzujuao	jboge'a	$g_1$ is Lojban grammar for structure/text $g_2$.
lojıbaqme	jbogri	$x_{1}$ is a Lojbanic group/organization with role/purpose/function $x_{2}$.
lojıbaqguo	jbogu'e	$x_1$ is Lojbanistan / Lojbanic country of people $x_2$
lojıbaqsı	jboju'i	$j_1$ is attentive towards/attends/tends/pays attention to object/affair $j_2=l_1$, which is lojbanic in aspect $l_2$.
lojıbaqcıao	jboklu	$l_1=k_1$ is of Lojbanic culture
lojıbaqsıaotoa	jbokravla	$x_1$ is a native Lojban word (not a borrowing) with meaning/role $x_2$
lojıbaqlaı	jbole'u	$le_1=lo_1$ (la'e zo BY/word-bu) is a letter/digit/symbol of Lojban’s alphabet representing $le_3$
lojıbaqpaı	jbope'o	$p_1$ is/acts as a friend to/of $p_2$ in the context of their shared interest in $j_1$ which reflects [Loglandic]/Lojbanic language/culture/nationality/community in aspect $j_2$
lojıbaqchoq	jbopli	$l_1=p_1$ uses Lojban for purpose $p_3$; $l_1=p_1$ is a Lojbanist.
lojıbaqdıu	jboske	$x_1=s_1$ is the science/study of Lojbanic language/culture based on methodology $x_2=s_3$; $x_1$ is a 'Lojbanology'.
lojıbaqkuq	jbosku	$x_1$ expresses/says $x_2$ (sedu'u/text) in Lojban, for audience $x_3$, via expressive medium $x_4$.
lojıbaqkeoı	jbosnu	$c_1$ (mass normally, but 1 individual/jo'u possible) discuss(es)/talk(s) about topic/subject $c_2$ in Lojban.
lojıbaqkeoı	jbota'a	$x_1$ talks/speaks in Lojban to $x_2$ about subject $x_3$
lojıbaqdeo	jbove'a	$l_1=v_1$ is a child who is a native speaker of Lojban.
lojıbaqtoa	jbovla	$x_1$ is a defined Lojban word, considered as a word as per Lojban's grammar, with meaning/role $x_2$
junaruo	je'utra	$x_1$ pretends $x_2$ is true; $x_1$ behaves as someone would behave if they knew $x_2$ to be true
joaguo	jefke'u	$k_1$ (event) occurs weekly as a repetition of (abstract) $k_2$ repeating (li) $k_3$ times (default: indefinitely)
joaguaıchaq	jefygundei	$x_1$ is a weekday (typical working day of the week) of week $x_2$, according to culture/custom $x_3$
junatoaı	jetka'u	$x_{1}$ is a quantum.
junaıq	jetkai	$x_1$ is genuinely $x_2$ (ka) by standard $x_3$
junadu	jetmlu	$x_1$ (du'u) seems true to $x_2$ by epistemology $x_3$
junajıe	jetpai	$p_1$ judges the veracity of $p_2=j_1$ by standard/epistemology/metaphysics $x_3=j_2$.
junasıu	jetsmi	$x_1$ seems to be the case to cognizer $x_2$.
junajeq	jetydu'i	$x_1$ and $x_2$ have the same truth value; either both or none of $x_1$ and $x_2$ is true
mıerıu	ji'exru	$x_1$ resurrects/brings back to life $x_2=j_1$ by standard $j_2$.
mıukuq	ji'isku	$j_1=c_1$ expresses/says opinion $c_2$ (sedu'u/text/lu'e concept) about subject/issue $j_3$ to audience $c_3$ via expressive medium $c_4$ on grounds $j_4$.
soaopoe	jiksei	$s_1=j_1$ is aloof/alone/solitary/a hermit, separated from $s_2=j_1$.
soaoruo	jiktra	$x_1=t_1=j_1$ behaves/conducts themself as/in-manner $x_2=t_2$ when interacting/behaving socially with $x_3=j_2$
soaocue	jiktru	$t_1$ is an institution governing social/cooperative human behaviour $t_2$.
soaomarao	jikydansu	$d_1=s_1$ (individual, mass) social dances with $s_2$ to accompaniment/music/rhythm $d_2$.
lohakuoq	jimbo'u	$j_1=b_1$ is a prosthetic bone made of metal, performing function $b_2$ in body $b_3$.
lohadealaq	jimdaxsna	$s_1$ is a zing/clang produced by metal $j_1=d_2=s_2$ being hit.
lohachaq	jimdei	$x_1$ is Friday of week $x_2$ on calendar $x_3$.
lohanhoq	jimsko	$j_1=s_1$ is a wire/cable of metal $j_2=s_2$
lohabaı	jimyzba	$x_1=z_1$ forges $x_2=z_2$ out of metal $x_3=z_1=j_1$
shoemtua	jirgau	$x_1=g_1$ immerses $x_2=j_1$ in liquid $x_3=j_2$
shoemsıqja	jirlu'i	$l_1$ (agent) bathes $l_2=j_1$ in liquid $j_2=l_4$.
shoemtaqsıqja	jirsezlu'i	$x_{1}$ is a wash-washed-immerse with removed by washing-immersed in $x_{2}$.
mıusho	jivbi'o	$b_1=j_1$ comes to the conclusion that $j_2$ [opinion] (du'u) is true about subject/issue $j_3$ on grounds $j_4$, under conditions $b_3$.
mıutua	jivgau	$x_1$ suggests that $x_2$ think $x_3$ (assertion); $x_1$ makes $x_2$ think $x_3$ (assertion)
puecheıpıu	jmadegycalku	$c_1$ is a toenail of toe $c_2=d_1$ of body $d_3$.
pueseaq	jmagle	$g_1$ masturbates/fucks $g_2$ with her/his feet.
pueguq	jmani'a	$j_1$ is a sole (part of foot) of $j_2$.
puetıa	jmati'e	$t_1$ is a heel of $j_2$.
coegaı	jonga'e	$x_1$ perceives concrete experience $x_2$ synesthetically as $x_3$ by means $x_4$ under conditions $x_5$
coechue	jonpoi	$p_1$ [ordered set] is a train/procession/caravan/string sequenced/ordered/listed by comparison/rules $p_2$ on unordered set $p_3=j_1=j_2$.
coecheo	jonsi'u	$x_1$ are joined at/by $x_2$.
coecheotua	jonsimgau	$g_1$ [person/agent] join $s_1$ together.
coekeoı	jonsnu	$x_1=j_3$ interprets discussion/relays messages between $x_2=c_1$ (set) about topic/subject $x_3=c_2$
kunalıaq	jufmei	$x_1$ is a paragraph about $x_2$ including sentence(s) $x_3$.
kunapaq	jufpau	$p_1$ is a phrase of sentence $p_2=j_1$ about $j_2$ in language $j_3$.
dualojı	junlogji	$l_1$ [rules/methods] is an epistemic logic for deducing/concluding/inferring/reasoning to/about $l_2$ (du'u).
haqbaıcıao	jupklu	$k_1$ is a cuisine pertaining to culture/geographical region/ethos/religion $k_2$ with dishes $j_2$ cooked/prepared by recipe(s)/method(s) $j_3$ (process).
haqbaırem	jupsfe	$x_1=s_1$ is a cooking surface for cooking $x_2=j_2$, surface of object $x_3=s_2$.
haqbaıbaı	jupyzba	$x_1$ cooks/prepares $x_2$ (cooked food) from ingredients $x_3$ by recipe/method $x_4$ (process)
juaobeoq	jvacmu	$ja_1=ji_1$ is a standard by which $ja_2=ji_2$ is true, set by community $ja_3$
juaozujuao	jvage'a	$x1=g_2$ (language) has regular grammar
juaotıao	jvamapti	$x_1=m_1$ conforms to/abides by/complies with rules/customs $x_2=m_2=j_1$
juaode	jvamle	$x_1=m_1=j_2$ is beautiful because it follows rule $x_2=j_1=m_3$ to observer $x_3=m_2$; $x_1$ is symmetrical (generalized sense to anything that is beautiful due to having a pattern).
toeshata	ka'arvi'u	$x1=k1=v1$ cuts off $x2=k3=v2$ from $x3=k2=v3$, leaving $x4=k3=v4$
toaımeta	ka'utre	$x_1$ is $x_2$ Planck lengths in direction $x_3$ by standard $x_4$
kafeshuaq	kafpra	$cu_1$ makes coffee/produces a quantity of coffee drink/product $cu_2=ck_1$ by process $cu_3$.
kafeshuaqkea	kafpraca'a	$ca_1$ is a coffeemaker/is an apparatus/device for producing coffee $ca_2=cu_2=ck_1$ controlled/[triggered] by $ca_3$ (agent).
kafesokum	kafsmuci	$s_1$ is/are coffee spoon(s) [item of cutlery] suitable for stirring and sipping the contents of a cup of coffee, made of material $s_3$.
kafepoaı	kaftsi	$t_1$ is/are (a) coffee bean(s) of coffee plant $t_2$.
kafeseao	kafxu'i	$x_1$ is caffeine with chemical purity $x_2$
kafeseaoshata	kafxumvi'u	$v_1$ decaffeinates/removes caffeine $v_2=x_1=c_1$ from $v_3$ with/leaving result/remnant/remainder $v_4$.
kafehaqbaıjoe	kafyjupcre	$c_1$ is a barista skilled at making coffee beverages $k_1$.
ıqceo	kaicfa	$x_1$ starts/begins to have property $x_2$
ıqbeo	kaicne	$x_1$ transitions to state $x_2$ from state $x_3$
ıqfa	kaikla	$x_1$ goes to (the place to) have property $x_2$
ıqmıeq	kaimre	$x_1$ measures, determinates (by sensorial examination) that property $x_2$ is satisfied by $x_3$.
ıqbeotua	kaircnegau	$x_1$ (agent) changes $x_2$ to state $x_3$ (ka) from state $x_4$ (ka).
ıqmıu	kairji'i	$x_1$ thinks/opines that $x_2$ is/does $x_3$ (ka) under grounds $x_4$
ıqjıe	kairpai	$x_1$ considers $x_2$ to have quality $x_3$ (ka) ; $x_2$ qualifies as / counts as being $x_3$ according to $x_1$
ıqpaq	kairpau	being $x_1$ (ka) is part of being $x_2$ (ka)
ıqtuaı	kairxadni	$x_1=xa_1$ is an avatar/physical embodiment of property/force $x_2=c_2$ (ka); $x_1$ is $x_2$ incarnate.
ıqchıa	kaitcu	$x_1$ needs to be/do $x_2$ (ka) for purpose $x_3$
kaqkıoq	kalboi	$b_1=k_1$ is an eyeball (body part) of $k_2$.
kaqjeoq	kalke'a	$x_1$ is the pupil of the eye of $x_2$
kaqcıu	kalvi'i	$v_1=k_2$ weeps/lacrimates tear(s) $v_2$ from $v_3$ via means/route $v_4$.
gaqcıabua	kancauxa'u	$x_1$ lives/resides alone in $x_2$
gaqmıu	kansmu	$x_1$ (du'u/si'o) is a connotation/undertone of $x_2$ (text or act of expression), recognized by $x_3$
gaqbua	kanxa'u	$xa_1=k_1$ is a roommate of/lives with $k_2$ at location/habitat/nest/home/abode $x_3=xa_2$.
rıapuefuq	karcutci	$c_1$ is a sandal for protecting feet $c_2$, and of material $c_3$.
chaobua	karcyzda	$z_1$ is a garage for car $z_2=k_1$
guokuq	ke'usku	$x_1$ repeats  $x_2$ (sedu'u/text) to audience $x_3$ via expressive medium $x_4$ for the $x_5$th time.
guogıaq	ke'uzgi	$x_1$ is a reprise / repeated musical passage produced by $x_2$ (event)
luaqshao	keidji	$x_1=d_1=k_1$ wants to play with plaything $x_2=d_2=k_2$ for purpose $x_3=d_3$.
luaqme	keigri	$k_1=g_1$ is a team / play group together playing / playing with plaything / toy / game $k_2=g_2$; members are from set $g_3$ linked by relations $g_4$.
luaqgıam	keirmu'u	$x_1$ is a moving piece used in a game $x_2$.
luaqtoq	keirta'o	$x_1$ is a board used for playing the game $x_2$.
luaqdoeme	kelci'e	$x_1$ is a game played by $x_2$ governed by rules $x_3$ interrelating game parts (physical or conceptual) $x_4$.
luaqmaı	kelpa'i	$k_1=p_1$ feels playful love towards $k_2=p_2$.
jeoqjıo	kevdi'u	$d_1=k_1$ is a dungeon excavated in or beneath $k_2$ for purpose $d_2$
jeoqtıeq	kevlu'a	$p_1=k_1$ is a tunnel through obstacle $k_2$, that stretches from $p_2$ to $p_3$ and goes through points $p_4$ (set)
jeoqshuaqshuao	kevypracpi	$ci_1=cu_1$ is a woodpecker/wryneck/piculet/sapsucker of species $ci_2$
jeoqbua	kevzda	$k_1=z_1$ is a cave for housing $x_2=z_2$, located in $x_3=k_2$.
bıqchaq	ki'odje	$d1$ is $d2$ full kilodays (thousand day unit) in duration (default is 1 kiloday) by standard $d3$
bıqnıaq	ki'orna'a	$n1$ is $n2$ millennia (1000 years) in duration (default is 1 millennium) by standard $n3$.
bıqmeta	ki'otre	$x_1$ is $x_2$ kilometres long in direction $x_3$ by standard $x_4$.
zıqdo	kibdu'a	$d_1$ uploads $d_2$ to $d_3=k_1$.
zıqcoe	kibjo'e	$x_1$ is online/connected to the internet with device $x_2$ via medium $x_3$
zıqnua	kibycpa	$c_1$ downloads $c_2$ from $c_3=k_1$.
zıqlueq	kibyse'u	$x_1=k_1=s_1$ is a server on the Internet for a client $x_2=k_1=s_2$ of service $x_3=s_3$.
zıqkuq	kibysku	$x_1$ expresses/says $x_2$ (sedu'u/text) over the internet for audience $x_3$, via online medium $x_4$.
zıqkeoırıaq	kibysnustu	$s_1$ is a Internet forum for $c_1$ to discuss/talk about topic/subject $c_2$.
fasue	klacpe	$c_1$ calls/summons $c_3=k_1$ to location $k_2$ in manner/form $c_4$.
fasuekea	klacpedyca'a	$ca1$ is pager for calling $ca2=cp3$ controlled/[triggered] by $ca3=cp1$
fahıu	klafle	$x_1$ is a flux/traffic of pedestrians/vehicles $x_2$ going to $x_3$ from $x_4$
fatua	klagau	$x_1$ brings $x_2$ to $x_3$
fasue	klami'e	$m_1$ summons $m_2=k_1$ to $k_2$ from $k_3$ via route $k_4$.
famuo	klamu'o	$x_1=k_1=m_1$ arrives at $x_2=k_2$ from $x_3=k_3$ by route $x_4=k_4$ with transportation means $x_5=k_5$ by completion standard $x_6=m_3$
fasuaı	klasutra	$s_1=k_1$ scurries to $k_2$ from $k_3$ through $k_4$ by means $k_5$
fachıa	klatcu	$x_1$ needs to go to location $x_2$ for purpose/action $x_3$
cıaobuıshatı	klubarcreka	$c_1=b_1=k_1$ is a jumper of material $c_2$.
cıaorıoq	klulei	$x_1=ku_1=kl_1$ is a cultural subset within a larger culture $x_2=kl_2$ with defining property $x_3=ku_2=kl_3$.
cıaopaq	klupau	$x_1$ is a meme of culture $x_2$
cıaoraq	klura'a	$s1$ pertains to culture of $s2=k2$
cıaodıu	kluske	$s_1$ is social anthropology.
reapeocaq	korgretro	$t_1$ controls $g_1=t_2$ who crosses $g_2=k_1$ to $g_3=k_2$ from $g_4=k_2$.
reatıeq	korlu'a	$x_1$ is the perimeter / circumference of shape/area $x_2$
sıaofaodaq	krafamtei	$x_1$ is the duration of $x_2$.
sıaobeotua	kraga'igau	$gas_1$ resets/changes $gal_1$ to its original value/content.
kıaqgueq	krebu'u	$b_1$ is an amount of velvet/velour/towelling/tufted cloth of type/material $b_2$.
kıaqsıqja	krelu'i	$x_1$ washes $x_2$'s hair, removing $x_3$ with shampoo $x_4$.
kıaqpıanete	kreplini	$x_1$ is a comet orbiting around $x_2$ with characteristics $x_3$, orbital parameters $x_4$, and coma/tail $x_5$
kıaqnıao	kresi'e	$s_1$ is dandruff on the head of $k_2$.
kıaqshata	krevi'u	$x_1=v_1$ shaves/[removes hair] $x_2=k_1=v_2$ from $x_3=k_2=v_3$ 
kıaqshatatorea	krevi'udakfu	$x_1=d_1$ is a razor with blade of material $x_2=d_3$
chılojı	krilogji	$l_1$ [rules/methods] is a doxastic logic for deducing/concluding/inferring/reasoning to/about $l_2$ (du'u).
chıcheu	kritcica	$x_1$ deceives $x_2$ into believing [implied falsehood] $x_3$ (du'u) about $x_4$
chıeqbeaq	kucyga'a	$x_1$ is a cross made of $x_2$.
chıeqbeaqlaı	kucyga'asni	$x_1$ is a crucifix.
chıeqcheotua	kucysimgau	$g_1$ folds/crosses/intertwines $s_1$(set).
chıeqtoa	kucyvla	$ x_1=v_1=k_1$ is a word/quotation crossing other words/quotations, meaning/defined by $x_2=v_2$, located at $x_3=k_3$
kuabuı	kumbartu	$b_1$ is outside of room $b_2=k_1$.
kuabua	kumyzda	$z_1=k_1$ is an apartment for $z_2$ in structure $k_2$.
leaqjeaq	la'irze'a	$z_1=l_1$ gets closer to $l_2$ in property $l_3$ by amount $z_3$.
baonam	labnanba	$n_1$ is white bread made from grains $n_2$.
baosho	labybi'o	$bi_1$ turns pale/white under condition $bi_3$.
baosıaı	labyblu	$c_1$ is lymph of animal $c_2$.
baocıe	labyfi'e	$f_1=b_1$ is a whitefish of genus/species $f_2$.
baoreo	labyska	$x_1$ is lightly colored with color $x_2$ [ka]
noaıbaoruanıu	ladlabrulspa	$x_1$ is a snowdrop (genus Galanthus) of species/strain $x_2$.
leaqpeo	lamgre	$x_1$ passes by $x_2$ to $x_3$ from $x_4$
leaqzeo	lamgrute	$g_1$ is an accessory fruit of $g_2$
leaqpeo	lampagre	$p_1=l_1$ passes by $p_2$ to $p_3$ from $p_4$ by $l_2$.
leaqpu	lampru	$l_1=p_1$ is recent, immediately preceding $l_2=p_2$.
leafıeq	larfi'i	$f_1$ is an artist creating work of art $f_2=l_1$ in medium $l_2$ for purpose $f_3$ from elements/ideas $f_4$ .
learıoq	larlei	$k_1$ is an artistic class/category/subgroup/subset within art $k_2=l_1$ with defining property $k_3$. $k_1$ is a genre.
leashuaq	larpra	$x_1$ is-an-artist/produces $x_2$ by artistic application of skill/craft $x_3$.
laqcaıshoı	laucmo	$x1=cl2=cm1$ roars $x2=cl1$, expressing $x3=cm3$
laqcaıkuq	lausku	$cu_1=cl_1$ shouts $cu_2$ (sedu'u/text/lu'e concept) for audience $cu_3$ via expressive medium $cu_4$, loudly by standard $x_5=cl_3$.
laqcaıchuo	lautci	$x_1$ is a loudspeaker.
luomuoq	lazmro	$x_1$ (family, taxon, clade) is extinct/extirpated.
luomaı	lazypa'i	$x_1$ feels familial/kinship love [storge] toward $x_2$
luobua	lazyzda	$z_1$ is the home of family members $z_2=l_2$.
luotaoluaq	lazyzukykei	$k_1$ (agent) plays house.
laıdoeme	lerci'e	$x_1=c_1$ is a script/writing system with rules $x_2=c_2$ among glyphs $x_3=c_3=l_1$ displaying $x_4=c_4$
laıkoekeakaıdoeme	lercu'aca'aci'aci'e	$x_1=ciste_1$ is a keyboard layout used by $x_2=ciska_1$ to enter letters/symbols $x_3=lerfu_1=ciska_2=cuxna_2$.
laılaqtıaosıo	lersnamatsi'o	$x_1$ is audio-visual isomorphism; the concept of letter(s) $x_2$ matching up one-to-one with sound(s) $x_3$
laıtoa	lervla	$v_1$ is a word which stands for the letter/digit/symbol $v_2=l_1$ in language $v_3$.
tıshaıkıao	li'avro	$v_1$ is an exit out of $c_2$.
gıume	lijgri	$g_1$ is a row (group) showing common property (ka) $g_2$ due to set $g_3$ linked by relations $g_4$.
leupıo	likro'i	$x_1=r_1=l_1$ is a quantity of lava/magma [liquid rock] of composition including $x_2=r_2=l_2$ from location $x_3=r_3$ under conditions $x_4=l_3$.
leupıopıo	likrokro'i	$x_1$ is a quantity of igneous rock of type/composition $x_2$ from location $x_3$
leutua	likygau	$g_1$ (agent) causes $l_1$ to be a quantity of liquid of composition $l_2$ under conditions $l_3$.
luafuaq	lisxra	$x_1=p_1$ is a comic strip about plot/subject/moral $x_2=l_2$ illustrated by $x_3=p_3$ with story written by $x_4=l_3$.
luakue	lisycku	$c_1$ is a story book containing story/tale/yarn/narrative $c_2=l_2$ by book author $c_3$ for book’s audience $c_4$ preserved in medium $c_5$.
luakuq	lisysku	$x_1$ tells story $x_2$ to $x_3$
tıshaıtua	livgau	$g_1$ causes $c_1$ to leave $c_2$ via route $c_3$.  
tıshaırıufa	livyxrukla	$x_1$ goes back and forth/commutes between $x_2$ and $x_3$ via route $x_4$ using means/vehicle $x_5$
meaqrıoq	lo'ikle	$k_{1}$ (mass/si'o) is a boat class with boats/defining property $b_{1}$=$k_{3}$ (ka).
meaqrıoq	lo'irlei	$k_{1}$ (mass/si'o) is a boat class with boats/defining property $b_{1}$=$k_{3}$ (ka).
lojızume	lojbangirzu	$x_1$ is the Logical Language Group (LLG).
lojızume	lojbaugri	$x_1$ is the Logical Language Group (LLG).
lojızudıu	lojbauske	$s_1$ is the science/craft-knowledge ('loglanology'/'loglangology') of logical language $s_2=b_1$ based on methodology $s_3$.
lojıkıao	lojvro	$v_1$ is a logic gate with inputs [pins] $v_2$ and output [pins] $v_3$ in circuit/system $v_4$.
lojınua	lojycpa	$x_1$ infers/concludes/draws conclusion $x_2$ from premise $x_3$ based on logic/reasoning $x_4$.
lojıdıu	lojyske	$x_1=s_1$ is the science of logic based on methodology $x_2=s_3$.
deaqgueq	lolbu'u	$x_1$ is a carpet
deaqguq	lolni'a	$c_1$ is underground/buried within ground $c_2=l_1$ of $x_3=l_2$.
deaqguqkua	lolnitku'a	$x_1$ is a cellar/basement in building $x_2$
deaqpıokıoq	lolro'iboi	$b_1=r_1$ is a cobblestone of material $b_2=r_2$ in floor $l_1$.
meaqrıoq	lotkle	$k_{1}$ (mass/si'o) is a boat class with boats/defining property $b_{1}$=$k_{3}$ (ka).
meaqrıoq	lotlei	$k_{1}$ (mass/si'o) is a boat class with boats/defining property $b_{1}$=$k_{3}$ (ka).
sıqjakua	lumku'a	$x_1=k_1$ is a bathroom, in which $x_2=l_1$ washes $x_3=l_2$ (self/other(s)/body part), in home/building/structure $x_4=k_2$ surrounded by partitions/walls/ceiling/floor $x_5=k_3$ (mass/jo'u)
tıeqfao	lutfa'o	$f_1$ is a dead end of route $f_2=p_1$ from origin $p_3$.
meıguobe	ma'arbakni	$b_1$ is a yak of species/type $b_2$
chaoshuotua	ma'ersrogau	$g_1$ parks vehicle $m_1=s_2$ in/at $s_3$.
koaqtua	ma'urgau	$g_1$ makes $m_1$ ripe/mature/grown
koaqnaqguobe	ma'urnakybakni	$b_1=n_1=m_1$ is a bull [adult male cattle/beef-producer/bovine] of species/breed $b_2$.
majıjoe	mafcre	$c_1=m_3$ is a wizard/sorcerer of $m_1=c_1$, which is magical to $m_2$, with standard of sorcery $c_3$.
majıchoq	mafpli	$p_1=m_3$ uses magic/casts spell $p_2=m_1$ for purpose/with intended effect $p_3$; $p_1=m_3$ is a magic user.
majıhıeq	mafre'o	$r_1=m_3$ casts magic spell $r_2=m_1$ at target $r_3$, $r_1=m_3$ is a "spellslinger".
majıkeoı	mafta'a	$x_1$ and $x_2$ magictalk about $x_3$
saırıe	maisru	$x_1=s_1=m_1$ is the material environment/surrounding material (i.e. gaseous/liquid atmosphere, vacuum, etc.) enclosing $x_2=s_2$ in direction(s)/dimensions(s)/plane $x_3=s_3=m_3$, of type/composition including $x_4=m_2$.
saıtua	majgau	$x_1$ creates / materializes / builds / makes $x_2$ out of / having it composed of $x_3$ and having shape / form $x_4$
majılua	makfyfi'a	$c_1$ is fantasy/magic-oriented fiction about plot/theme/subject $c_2$ by author $c_3$, based on magic $m_1$ 
huıjıaolaı	malceisni	$s_1$ is an idol/a sign/symbol representing god/demon/property (perjorative sense) $s_2$ to observer $s_3$.
huıchua	malcme	$m_1=c_1$ is a derogatory / abusive / insulting name for $m_2=c_2$ as used by $m_3=c_3$; $m_3=c_3$ "name-calls" $m_1=c_1$.
huıhaq	maldja	$c_1$ is junk food for $c_2$.
huııqlı	malgli	$g_1=m_1$ is an anglicism (in Lojban), inappropriate according to $m_3$.
huıromchuo	malsamtci	$x_1$ is [malware/malicious software/computer virus] for purpose $x_2$ on computer(s) including $x_3$
huıchıa	maltcu	$n_1$ is dependant on/addicted to/can't go without drug/addictive substance $n_2$ due to type of addiction/withdrawal symptoms $x_3$ .
huıtoa	malvla	$x_1$ is a "bad word" / swear-word meaning $x_2$ in language $x_3$
huıbua	malxa'u	$x_1$ infests/damnedly lives in $x_2$, terrible by standard/according to $x_3$
tıaocıao	matklu	$m1$ corresponds to culture of $m2=k2$ in aspect $m3$
tıaocheojue	matsi'uma'i	$x_1$ is June of year $x_2$ in calendar $x_3$.
tıaozu	matybau	$m_1$ corresponds to language of $m_2=b_2$ in aspect $m_3$
tıaosho	matybi'o	$b_1$ becomes fitting with $m_2$ in property/aspect $m_3$.
lıaqıq	memkai	$x_1$ is/are $x_2$ (li) in number, and are among $x_3$
lıaqjeaq	memyze'a	$x_1$ increases in number by amount $x_2$
moıchujoe	mencre	$c_1=m_2$ (person) is intelligent/smart by standard $c_3$.
moıchuchuq	mencti	$c_1$ reads/watches/listens to/mentally consumes $c_2$.
moıchufaq	menfau	$f_1=m_1$ (event) is a mental event that happens/occurs/takes place in a/the mind of $m_2$; x1 is an incident/happening/occurrence of thought/dream/feeling/realization or any other mental activity .
moıchumajı	menmakfa	$x_1$ is psychic magic/power to $x_2$ performed by $x_3$.
moıchude	menmle	$x_1=melbi_1=menli_2$ has a mind that is beautiful to $x_2=melbi_2$ in aspect $x_3=melbi_3$.
moıchugıamtua	menmuvgau	$g_1=me_1$ telekinetically / with its mind moves $mu_1$ to destination/receiver $mu_2$ [away] from origin $mu_3$ over path/route $mu_4$
moıchupoetua	menseigau	$x_1$ distinguishes / differentiates / discriminates between $x_2$ and $x_3$
moıchupoetuadeq	menseigauka'e	$x_1=k_1$ is able to distinguish between $x_2=ms_1$ and $x_3=ms_2$ under conditions $x_4=k_3$
moıchupoedeq	menseika'e	$x_1=k_1$ is able to distinguish between $x_2=ms_1$ and $x_3=ms_2$ under conditions $x_4=k_3$
moıchudıu	menske	$s_1$ (mass of facts) is mental science/psychology about subject matter $s_2$ based on methodology $s_3$.
moıchudıuchoqcheu	menskeplitcica	$x_1$ uses reverse-psychology/psychologically-based trick $x_2$ (abstraction; instance or idea of the trick) against $x_3$ in order to effect $x_4$.
moıchukuq	mensku	$x1=m2=c1$ thinks/[mentally says to oneself] $x2=c2$ (sedu'u/text/lu'e concept)
moıchubua	menzda	$x_1=z_1$ is a brainhouse of $x_2=z_2=m_2$
suesue	mi'ecpe	$m_1=c_1$ demands/exacts $c_2=m_3$ of $c_3=m_2$, with manner/form of demand $c_4$.
suesuekuq	mi'ercpesku	$cu_1=cp_1=m_1$ demands $cu_2=cp_2=m_3$ (text) from $cu_3=cp_3=m_2$ via medium $cu_4$
suemuqchoq	mi'erxanpli	$m_1=xa_2=p_1$ commands/orders to $m_2$ using hand (gesture) $xa_1=p_2$ to do/bring about $m_3$. 
suekuq	mi'esku	$x_1=m_1=c_1$ expresses/states command $x_2=c_2$ to recipient(s) $x_3=m_2=c_3$ via expressive medium $x_4=c_4$.
kealea	mi'irlarcu	$l_1$ is a technology based on the application of craft $l_2$.
kealealua	mi'irlarfi'a	$c_1$ is technology-oriented science fiction about plot/theme/subject $c_2$ by author $c_3$, based on technology $l_1$.
keasıumarao	mi'irsmidansu	$d_1$ (individual, mass) performs robot dance/dances like a machine to accompaniment/music/rhythm $d_2$.
suejuo	midnoi	$n_1$ is an instruction for $n_2=m_3$ (event/state) to occur, issued by $n_3=m_1$ for intended recipient $n_4=m_2$.
suetoa	midvla	$v_1$ is a command word/keyword ordering $v_2=m_3$ (event/state) in language $v_3$.
meachue	mimpoi	$x_1$ is a sequence of members $x_2$, $x_3$, $x_4$, ... in that order.
jeqchuapoq	mitcmepre	$x_{1}$ (person) is a/the namesake of $x_{2}$ (person).
jeqdu	mitmlu	$s_1=m_1$ seems to be the same as $m_2$ by standard $m_3$ to observer $s_3$ under conditions $s_4$.
jeqmıutoa	mitsmuvla	$v_1=m_1$ is a synonym of $m_2$ by standard $m_3$ in language $v_3$.
jeqlaqtoa	mitsnavla	$x_1$ is a homophone to $x_2$, and means $x_3$ in language $x_4$
jeqdıeqcheo	mitybe'isi'u	$s_1$ (set) mutually synchronize $b_2$ via transmission means/medium $b_5$
mıetua	mivgau	$g_1$ reincarnates/resurrects $j_1$ by standard $j_2$.
mıeroıkea	mivjoimi'i	$x_1$ is a cyborg/cybernetic organism. $x_1$ has organic part(s) $x_2$ and biomechatronic/cybernetic part(s) $x_3$.
mıemuoq	mivmro	$m1$ is alive after being dead/ceasing to be alive; m1 is a zombie.
mıejıaq	mivmu'e	$m_1$ is nature/the world of living things $m_2=j_1$, defined by rules $m_3$.
mıebushaı	mivnalsti	$j_1=s_2$ is immortal by standard $j_2$. 
mıetoaıgoeq	mivyslebi'u	$b_1$ is a cell wall separating cell $j_1=s_1=b_2$ from extracellular environment $b_3$.
mıeseao	mivyxu'i	$xu_1$ is an instance of chemical substance $xu_2$ derived from biological source $j_1$.
lıacıe	mlafi'e	$f_1$ is a flatfish of family/genus/species $f_2$, swimming with side $m_1$ upward.
lıafa	mlakla	$x_1=k_1=m_4$ dodges/sidesteps/skirts $x_2=m_2$ from $x_3=k_3$ by route $x_4=k_4$ by means of transportation $x_5=k_5$.
desuoı	mleba'i	$m_1=b_1$ is splendid/glorious/magnificent to $m_2$ in aspect $m_3$ (ka) by aesthetic standard $m_4$, and by greatness standard $b_4$.
depoıba	mlesrasu	$x_1$ is a blade/expanse of agave (genus Agave) of species/strain $x_2$.
tuaochoa	mliba'u	$x_1=m_1=b_1$ whispers/mumbles/murmurs/coos utterance $x_2=b_2$; $x_1=m_1=b_1$ speaks softly.
tuaosao	mlibra	$b_1=m_1$ is somewhat big in dimension $b_2$ by standard $b_3$.
tuaofeıchoa	mlifegba'u	$m_1=f_1=b_1$ grumbles with sound $b_2$ at $f_2$ because of $f_3$ (action/state/property).
tuaoloq	mligla	$g_1=m_1$ is warm by standard $g_2$.
tuaoca	mliri'a	$r_1$ (event/state) mildens/allays/alleviates effect $r_2$ (event/state) under conditions $r_3$.
durubuıq	mlujvenarkai	$c_1=s_1$ seems to have property/properties $c_2=s_2$ to observer $s_3$ under conditions $s_4$ but it actually does not have that property / these properties.
moaqbuaq	mo'ifli	$x_1$ fails to remember $x_2$ ; $x_1$ is unable to remember $x_2$
moaqtua	mojgau	$g_1$ reminds $m_1$ of facts $m_2$ about $m_3$.
moaqtuajuo	mojgaunoi	$x_1=n_1$ is a message reminding facts $x_2=m_2$ about $x_3=m_3=n_2$ from author $x_4=n_3=g_1$ to intended audience $x_5=n_4=m_1$.
moaqbudeq	mojnalka'e	$k_1$ is unable to/incapable of remembering $k_2$ under conditions $k_3$. $k_1$ has amnesia/memory loss.
moaqreaq	mojvei	$x_1=v_1$ is a note containing/recording facts/thoughts/ideas $x_2=m_2=v_2$ (du'u) about subject $x_3=m_3=v_3$ in/on journal/notebook/note $x_4=v_4$ from author $x_5=m_1$
buqbeaı	moldandu	$x_1=d_1$ is the uvula in the mouth of $x_2=m_2$.
buqgao	molgapru	$g_1$ is the palate of $m_2$.
buqlıakuoq	molmlabo'u	$b_1$ is a/the cheekbone/malar bone/zygomatic bone (os parietale) performing function $b_2$ in body of $b_3$.
buqnueq	molre'u	$x_{1}$ is a meat with has mouth $x_{2}$. (a bit too unspecific).
buqleu	molylitki	$x_1$ is saliva of organism $x_2$
mıeqbeoq	mrecmu	$x1$ is a standard of $x2$ ($x2$ can be anything used for measurement or comparison)
mıeqzıu	mrena'u	$n_1$ is a real number.
muoqsho	mrobi'o	$b_1$ dies under conditions $b_3$.
muoqchuqshuao	mrocticpi	$cip_1=cit_1$ is a vulture of species $cip_2$.
muoqmeo	mrodri	$b_1$ mourns/grieves over the death of $m_1$ 
muoqdueq	mrofoi	$f_1$ is a cemetery/graveyard/burial ground for dead person(s)/animal(s) $m_1$.
muoqdeq	mroka'e	$m_1=k_1$ is mortal/capable of dying under conditions $k_3$.
muoqjeoq	mroke'a	$k_1$ is a grave in ground $k_2$ for $m_1$.
muoqmajı	mromakfa	$x_1=m_1$ is death magic/necromancy as observed by $x_2=m_2$, performed by person/force/deity $x_3=m_3$.
muoqbuseo	mronalspe	$x1$=$s1$ is widowed from $x2$=$m1$=$s2$ by law/convention $x3$=$s3$
muoqca	mrori'a	$x_1$ is the cause of $x_2$'s death under conditions $x_3$; $x_1$ kills $x_2$.
muoqseo	mrospe	$x_1=s_1$ is widowed from $x_2=m_1=s_2$ by law/convention $x_3=s_3$
muoqrıaq	mrostu	$s_1$ is the grave/tomb of $m_1=s_2$.
muoqheq	mrovau	$v_1$ is a coffin containing $v_2=m_1$.
muoqtuaı	mroxadni	$x_1$ is the corpse / dead body of $x_2$
jıaqsıaodıu	mu'erkraske	$x_1$ is cosmology (in astronomy) based on methodology $x_2$
jıaqdıu	mu'eske	$s_1$ is cosmology based on methodology $s_3$.
jıaqcue	mu'etru	$t_1$ is a lord of universe $t_2=m_1$.
muaosaıgoeq	mudbi'u	$b_1=m_1$ is a wooden wall/fence separating $b_2$ and $b_3$ (unordered) of/in structure $b_4$ made out of tree of type $m_2$
muaosaıbeaq	mudga'a	$g_1=m_1$ is a wooden stick/pole/staff/cane made from tree(s) of type/species $m_2$.
muaosaıpuefuq	mudycutci	$c_1$ is a wooden shoe for covering/protecting [feet] $c_2$, and is of [wooden] material $c_3=t_1$.
muaosaıchaq	mudydei	$x_1$ is Thursday of week $x_2$ on calendar $x_3$.
muaosaıloe	mudyfagri	$f_1$ is a wood fire burning in/reacting with oxidizer $f_3$.
muaosaıtoepoq	mudyka'apre	$p_1$ is a woodcutter/lumberjack using tool $k_1$ to cut trees of species $m_2$.
muaosaınıu	mudyspa	$s_1$ is a woody plant/(gnetophyta) of species/strain/cultivar $s_2=m_2$ producing wood $m_1$.
muaosaınıudıu	mudyspaske	$s_1$ is dendrology/xylology about woody plant(s) $m_2=s_1=s_2$.
jıaqgueqkıao	mujybukyvro	$v_1$ is a wormhole (physics)
muosho	mulbi'o	$x_1$ is completed in property $x_2$ according to standard $x_3$
muonaı	mulcabna	$x_1$ (event) is after $x_2$ (event) concludes. $x_1$ is in the future when $x_2$ finishes
muofao	mulfa'o	$f_1$ is the end/finish/completion of completed thing/process $f_2=m_1$.
muofaq	mulfau	$x_1$ (event) completes / reaches its completion
muome	mulgri	$g_1=m_1$ is a complete set showing common property (ka) $g_2$, complete by standard $m_3$.
muome	mulgunma	$g_1=m_1$ is a mass/team/aggregate/whole, together composed solely/completely/wholly of components x2, considered jointly, by standard $m_3$.
muojuı	muljbi	$x_1$ is almost/nearly done/complete/finished/whole in property $x_2$ by standard $x_3$.
muosı	mulju'i	$x_1$ concentrates on $x_2$.
muofa	mulkla	$k_1=m_1$ arrives at $k_2$ from $k_3$ via route $k_4$ by means $k_5$.
muozıutoaı	mulna'usle	$s_1=mn_1$ is an indivisible / prime number in integer domain $s_2$.
muotoaıchumıe	mulslemijyji'e	$x_1$ is a eukaryote of species $x_2$.
gıambeaı	muvdandu	$x1=m1=d1$ swings on $x2=d2$ towards $x3=m2$ from $x4=m3$
gıamtua	muvgau	$g_1$ moves $m_1$ to destination $m_2$ from origin $m_3$ over path/route $m_4$.
gıamcıa	muvycau	$x_1$ is motionless
gıamsuaı	muvysutra	$x_1$ is quick to move to destination $x_2$ away from origin $x_3$ over path/route $x_4$
gıamchuobeaq	muvytciga'a	$g_1=t_1$ is a joystick for steering/manoeuvring object/vehicle $m_1=t_2$ of material $g_2$.
gıamchuosıoq	muvytcixi'u	$x_1=t_1$ is a steering wheel for steering/manoeuvring object/vehicle $m_1=t_2$, made of materials/having properties $x_3$.
gıamfuaq	muvyxra	$p_1$ is an animation featuring characters $p_2=m_1$, made by artist $p_3$ in medium $p_4$
gıamtı	muvzva	$x_1$ wanders within an area $x_2$.
nıaqsıu	na'asmi	$x_1$ is of the same/similar age as $x_2$
zıujuı	na'ujbi	$x_1$ is approximately equal to $x_2$.
zıutoa	na'uvla	$x_1$ is the word with stands for the number $x_2$ in language $x_3$
namloqkea	nabglaca'a	$x_1$ is a toaster
namnhoq	nabysko	$x_1$ is a quantity of noodles.
namtoaı	nabysle	$x1=s1$ is a crumb of bread $x2=n1$ from grain $x3=n2$
nambaı	nabzba	$z_1$ bakes bread/cake/pastry $z_2=n_1$ from ingredients $z_3$.
zıuıq	nackai	$c_1$ is characterized by numbers; $c_1$ is digital.
zıuchua	nacme'e	$x_1=n_1=c_1$ is a numerical identifier of $x_2=c_2$, used by $x_3=c_3$.
zıulıaq	nacmei	$x_1$ is a vector of dimension $x_2$ with coordinates $x_3$, $x_4$, $x_5$, ...
zıulıaqlıaq	nacmeimei	$x_1$ is an $x_2$ by $x_3$ vector array/matrix of vectors $x_4$, $x_5$, $x_6$...
zıuchuechoa	nacpoiba'u	$b_1$ counts numbers $n_1=p_1$ out aloud.
zıuteoq	nacrei	$p_1$ is a question about a number, asked by $p_3$ to $p_4$.
zıutoachue	nacyvlapoi	$x_1$ (quoted text) is the text that stands for the number $x_2$ in language $x_3$
naqjıao	nakcei	$c_1$ is a god (specifically, male deity) of people(s)/religion $c_2$ with dominion over $c_3$ [sphere].
naqtuao	nakmli	$n_1=m_1$ is a demiboy.
naqbuseo	naknalspe	$f_1=n_1$ is an unmarried man under law/custom/tradition $s_3$.
naqsıulıqsıo	naksmifetsi'o	$si_1$ is feminism, the idea that females and males are alike in quality $sm_3$, as thought by $si_2$.
naqguobe	nakybakni	$b_1=n_1$ is a bull of species/breed $b_2$.
bukıoqsho	nalbolbi'o	$bi_1$ unrolls under condition $bi_3$.
busaomeaq	nalbrablo	$ba_{1}$=$bl_{1}$ is a non-big boat for carrying $bl_{2}$, propelled by $bl_{3}$, in property/dimension(s) $ba_{3}$ (ka) as compared with standard/norm $ba_{3}$.
bujıaodua	nalceiju'o	$d1$ does not know if a god(s) exist; d1 is agnostic.
bujıaochı	nalceikri	$k_1$ is an atheist.
bunıo	nalci'o	$x_1$ is senior/older/other than young by standard $x_2$.
bujoe	nalcre	$c_1$ is lay (non-professional) in event/activity $c_2$ by standard $c_3$.
buchuq	nalcti	$c_1$ abstains from eating $c_2$; $c_1$ fasts.
bushao	naldjica	$x_{1}$ does not want/desire $x_{2}$ (event/state) for purpose $x_{3}$.
budue	naldra	$x_1$ is incorrect/not right in property/aspect $x_2$ (ka) in situation $x_3$
bufaq	nalfau	$x_1$ (event) is an event that doesn't happen/occur/take place
buguaıchaq	nalgundei	$x_1=d_1$ is a period of $x_2=d_2$ non-working days/vacation days/holidays for worker $x_3=g_1$ at job $x_4=g_2$
busı	nalju'i	$x_1$ is inattentive towards/distracted/inadvertent of object/affair $x_2$.
busıluaq	nalju'ikei	$x_1$ fidgets with $x_2$.
budua	nalju'o	$d1$ does not knows fact(s) $d2$ (du'u) about subject $d3$ by epistemology $d4$
busı	naljundi	$j_1$ is inattentive towards/distracted from object/affair $j_2$.
budeq	nalka'e	$k1$ is unable to do/be/uncapable of doing/being (event/state) $k2$ under conditions $k3$ (event/state)
bukafeseaokafe	nalkafxumckafi	$c_1=x_1$ is a quantity of decaffinated coffee/coffee [beverage] without caffeine.
bude	nalmle	$m_{1}$ is ugly to $m_{2}$ in aspect $m_{3}$ (ka) by aesthetic standard $m_{4}$.
bumoaq	nalmo'i	$m_1$ forgets fact/memory $m_2$ about subject $m_3$.
bumuo	nalmu'o	$x_1$ is incomplete/unfinished in property $x_2$ by standard $x_3$ .
buzıu	nalna'u	$n_1$ is not a number
buraq	nalra'a	$x_1$ is irrelevant/unrelated to $x_2$; $x_1$ is arbitrary in relation to $x_2$ [object of comparison; context or referent].
bunueqchuq	nalre'ucti	$c_1$ does not eat meat $c_2=r_1$; $c_1$ is a (lacto-ovo-)vegetarian.
bureqnıaı	nalremda'u	$x_1$ is a non-human animal of species/taxon $x_2$
burıtı	nalri'i	$r_1$ (NU) is casual, not formal/ceremonial.
buseo	nalspe	$f_1=n_1$ is unmarried under law/custom/tradition $s_3$.
bushaı	nalsti	$s_1$ (agent) is relentless/unceasing in activity/process/state $s_2$.
bukeoımoe	nalta'acni	$c_1=t_1$ is withdrawn, feeling emotion $c_2$ about $c3=t_3$ from $t_2$.
busuao	nalvai	$x_1$ (event/person) is unimportant/insignificant to $x_2$ (event/person) due to/in aspect $x_3$; $x_2$ doesn't care about $x_1$'s $x_3$-ness.
buceuguqshoem	nalvaxni'ajinru	$j_1=c_1=v_1$ (object/person) is free-diving beneath/below/under from $c_2$ (object/water surface) in frame of reference $c_3$, submerged in liquid $j_2$.
buceuguqshoempoq	nalvaxni'ajirpre	$p_1$ is a free-diver.
butı	nalzva	$x_1$ is absent from $x_2$.
namıafarı	nanfi'o	$x_{1}$ is an African with African aspect $x_{2}$.
namıafarııqlızu	nanfi'oglibau	$x_1$ is the South African English language used by $x_2$ to express/communicate $x_3$ (si'o/du'u, not quote).
namıafarıguo	nanfi'ogu'e	$x_1$ is South Africa.
namıhochuhochunamı	nansunsunsnanu	$x_1$ is southeast by east of $x_2$ in frame of reference $x_3$.
budaı	narcu'i	$x_1$ (event/state/property) is impossible under condition $x_2$
bunıaıshuaqchoq	nardalprapli	$p_1$ is a (ethical) vegan, not using animal products $c_2$.
bushao	nardji	$x_1$ wants $x_2$ to not happen, for purpose $x_3$.
bushaorutua	nardjijevgau	$x_1$ (agent)'s action results in the unintended result $x_2$
bushaorutua	nardjijvegau	$x_1$ (agent)'s action results in the unintended result $x_2$
bufaq	narfau	$x_1$ (event) is an event that doesn't happen/occur/take place
bufaqdaı	narfaucu'i	under conditions $x_2$, it is possible that $x_1$ (event/state/property) doesn't happen
bufaqbudaı	narfaunarcu'i	under conditions $x_2$, it is not possible that $x_1$ (event/state/property) doesn't happen / $x_1$ necessarily happens
bujuna	narje'u	$x_1$ (du'u) is not true by standard/epistemology/metaphysics $x_2$
budeq	narka'e	$k_1$ is unable to do/be/uncapable of doing/being $k_2$ (event/state) under conditions $k_3$ (event/state).
buıq	narkai	$x_1$ lacks property $x_2$.
buchoqgı	narplixau	$x_1$ is useless to agent $x_2$ by the standard of purpose $x_3$
buchoqhuı	narplixla	The use of $x_1$ for purpose $x_2$ is discouraged in favour of the use of $x_3$, whose age is less than the age of $x_1$, because $x_3$ is superior to $x_1$.  $x_1$, when used for purpose $x_2$, is deprecated in favour of $x_3$.
bupugaıcheu	narprugastcica	$x_1$ (event) causes jamais-vu to $x_2$ (person) using sense $x_3$ under conditions $x_4$
buromcoe	narsamjo'e	Computer $j=1=s_1$ is disconnected from [not connected to] computer $j_2=s_1$ via medium $j_3$.
buromcoetua	narsamjongau	$g_1$ (agent) disconnects computer $j=1=s_1$ from computer $j_2=s_1$ in medium $j_3$.
buhuodeq	nartinka'e	$k_1$ is deaf/unable to hear under conditions $k_3$ (event/state).
bukaqdeq	narviska'e	$k_1$ is blind/unable to see under conditions $k_3$ (event/state).
bureqnıaı	naryremda'u	$d_1=r_1$ is an animal of species $d_2$ and not a human; $d_1=r_1$ is a non-human animal.
boakıaq	ne'okre	$x_1$ is a mane on $x_2$
boabeaıshatı	nebdadycreka	$cr_1=d_1$ is a halter top of material $cr_2$.
boatoe	nebyka'a	$k_1$ is a guillotine/executioner's axe for beheading $k_2$.
boatoekea	nebyka'aca'a	$x_{1}$ is an apparatus with apparatus operator $x_{2}$.
nıehıe	nerbei	$x_1$ imports $x_2$ to $x_3$ from $x_4$ via $x_5$ .
nıesho	nerbi'o	$x_1=b_1=n_1$ enters [becomes inside-of] $x_2=n_2$ under conditions $x_3=b_3$
nıeshatı	nercreka	$c_1$ is a singlet/undershirt/vest of material $c_2$.
nıerıa	nerkalri	$x_1$ is an entrance/entry/entryway/inlet/way in to $x_2$ for $x_3$ .
nıebuqnueq	nermolre'u	$x_{1}$ is a meat with turns out a bit too unspecific $x_{2}$.
guqmeaq	ni'ablo	$x_1$ is a submarine for carrying $x_2$, propelled by $x_3$.
nıqtue	nincu'u	$cu_1=cn_1$ is a new business involving persons $cu_2$
nıqtuepoq	nincu'upre	$p_1$ is an intrepreneur involved in business $cu_1=cn_1$
nıqbeotua	ninga'igau	$gas_1$ resets/changes $gal_1$ to a new value/content.
nıqpoq	ninpre	$c_1=p_1$ is a stranger to $c_2$ in aspect $c_3$ by standard $c_4$
guqgıam	nitmu'u	$x_1$ moves down to $x_2$ from $x_2$
guqchue	nitre'e	$x_1$ is a subway train consisting of cars $x_2$.
guqshoem	nityjinru	$j_1=c_1$ (object/person) dives beneath/below/under from $c_2$ (object/water surface) in frame of reference $c_3$, submerged in liquid $j_2$ .
guqshoemfa	nityjirkla	$k_1=j_1=c_1$ dives to destination $k_2$ from origin $k_3$ via route $k_4$ using means/vehicle $k_5$ in  liquid $j_2$ beneath/under/down from $c_2$ (object/water surface) in frame of reference $c_3$.
guqshoemchao	nityjirma'e	$m_1$ is a diver propulsion vehicle (DPV) carrying $m_2=j_1=c_1$ (diver/object), propelled by $m_4$.
guqtuı	nitytse	$z_1$ sits on surface $z_2=c_1$ that is below $c_2$ in frame of reference $c_3$.
juokuq	noisku	$c_1$ announces/proclaims $c_2$ (sedu'u/text/lu'e concept) for audience $c_3=n_4$ via expressive medium $c_4$.
ruaısuoı	nolba'i	$b_1=n_1$ is titled with high aristocratic/noble/elite status in/under culture/society $b_3=n_2$.
ruaıkıoq	nolboi	$x_1$ is an orb made of  $b_2$ used by $n_1$.
ruaıgaq	nolkansa	$k_1$ is a courtier to sovereign/aristocrat/noble $k_2$ in culture/country $n_2=k_3$.
ruaıde	nolmle	$m_1=n_1$ is elegant to $m_2=n_2$.
ruaılueq	nolse'u	$s_1$ is a servant of  sovereign/aristocrat/noble $s_2=n_1$ in culture/country $n_2$ with responsibilities $s_3$.
ruaıcuelıq	noltrufe'i	$x_1$ is a queen/empress reigning over $x_2$
ruaıbua	nolzda	$z_1$ is a palace of/for noble person(s) $n_1=z_2$.
ruaıgıaq	nolzgi	$z_1=n_1$ the classical music performed at/by $z_2$ (event) originating in culture $n_1$.
juokaı	notci'a	$c_1$ notes down $c_2$ on display/storage medium $c_3$ with writing implement $c_4$.
juokuq	notsku	$c_1$ announces/proclaims $c_2$ (sedu'u/text/lu'e concept) for audience $c_3=n_4$ via expressive medium $c_4$.
paqguo	pagygu'e	$p_1=g_1$ is a constituent country of $p_2$ (sovereign state / supranational body).
paqdıem	pagzai	$x_1=z_1$ is a department store selling/trading (for) $x_2=z_2$, with departments $x_3=z_3=p_1$
jıecuedoeme	pairtruci'e	$c_1=t_1=p_1$ is the judicial branch of the government of people/territory/domain/subjects $t_2$. 
maınoı	pamcro	$x_1$ experiences so-called 'heartache'/love-pain.
maıkaqsı	pamcta	$c_1=p_1$ lovingly looks at/views/regards/watches/gazes at $c_2=p_2$
maıruanıu	pamrulspa	$l_1$ is a lily of the Nile/African lily (genus Agapanthus) of species/strain $l_2$.
maıcheo	pamsi'u	$x_1$ love each other; $x_1$ are in love
maıpoıba	pamsrasu	$x_1$ is lovegrass of species/variety $x_2$.
shılıaq	pavmei	$m_1$ is singular.
shımuaosaımeaq	pavmudblo	$x_1$ is a dugout for carrying $x_2$
shıgujue	pavrelma'i	$x_1$ is December/the twelfth month of year $x_2$ in calendar $x_3$.
shıgujue	pavrelmasti	$x_1$ is December/the twelfth month of year $x_2$ in calendar $x_3$.
shıfaq	pavyfau	$x_1$ is a one-time event/occurrence; $x_1$ does not happen again.
shıfaqchuo	pavyfautci	$x_1$ is a single-use/one-time tool/utensil/resource/implement used for doing $x_2$ (and discarded afterward).
shıkopıtoa	pavyfu'ivla	$x_1=v_1=f_1$ is a stage 1 fu'ivla meaning $x_2=v_2$, based on word $x_3=f_2$ in language $x_4$.
shırıalaq	pavykarsna	$x_1$ (sound, text) is a monophthong.
shıshıjue	pavypavma'i	$x_1$ is November/the eleventh month of year $x_2$ in calendar $x_3$.
shıshıjue	pavypavmasti	$x_1$ is November/the eleventh month of year $x_2$ in calendar $x_3$.
shıpıanete	pavyplini	$p_1$ is the closest planet (default is Mercury if p2 is the Sun) revolving around $p_2$ (default is the Sun), with planetary characteristics $p_3$, orbital parameters $p_4$.
shıchoqchuo	pavyplitci	$x_1$ a single-use tool/implement/implement for doing $x_2$; $x_1$ is designed to be discarded after the first use.
shıpoe	pavysei	$p_1=s_1$ is alone, lacking the company of $s_2$.
shısıu	pavysmi	$x1$ is the one(-like) element/multiplicative identity of structure/ring $x2$; often is denoted by  ' $1_R$ ' or  ' $I_R$  ' or by  (when context is obvious)  '1' or 'I', for structure/ring R (given by $x2$).
shımıu	pavysmu	$s_1$ is the single, unambiguous meaning of $s_2$ recognized/accepted by $s_3$; $x_2=s_2$ is unambiguous/explicit according to $x_3=s_3$.
shıteı	pavytai	$t_1$ is monomorphic.
shıcıu	pavyvi'i	$p_1=v_2$ urinates, "goes number 1" from source $v_3$ via means/route $v_4$
shıseaı	pavyxalka	$x_1$ is a quantity of methanol from source $x_2$
shısıoqchao	pavyxilma'e	$m_1$ is a unicycle/one-wheeled vehicle carrying $m_2$ in/on surface/medium $m_3$, propelled by $m_4$.
paımoe	pe'ocni	$x_1$ feels friendship towards $x_2$
paımaı	pedypa'i	$x_1$ feels friendly/fraternal love [philia] toward $x_2$
paıcheo	pedysi'u	$x_1$ are friends (of each other, distributively)
moıpoq	peipre	$pr_1=pe_1$ is an intellectual thinking thoughts/reflecting upon $pe_2$.
moırıu	peixru	$x_1=p_1$ thinks back to origin/earlier state $x_3$ about $p_2$ (abstraction).
geqtua	pengau	$g_1$ introduces $p_1$ to $p_2$  at/in location $p_3$.
geqcheo	pensi'u	$x_1$ (set) meet at $x_2$ (location).
geqdıu	penske	$x_1$ is a (so-called) science for socialization/matching/meeting between subjects $x_2$ in context/for purpose $x_3$, using methods $x_4$.
geqkuq	pensku	$x_1$ thinks thought / verbally thinks $x_2$ (quote)
moıdıu	pesyske	$s_1$ is cognitive science/cognitive psychology, of/about subject matter $s_2$ based on methodology $s_3$.
lomapeo	pi'egre	$pl_1=pa1$ (agent/object) leaps/jumps/springs/bounds, passing through $pa_2$ to $pa_3=pl_2$ from $pa_4=pl_3$ reaching height $pl_4$ propelled by $pl_5$.
lomamuoı	pipcarna	$c_1=p_1$ somersaults over $c_2$ in direction $c_3$ to $p_2$ from $p_3$.
lomafa	pipkla	$k_1=p_1$ skips/hops to $k_2=p_2$ from $k_3=p_3$ via route $k_4$.
lomagıam	pipmu'u	$x1=p1=m1$ bounds/[moves in jumps] to $x2=p2=m2$ from $x3=p3=m3$ via route $x4=m4$ and jump height $x5=p4$
lomakıoq	pipyboi	$b_1$ is a bouncy ball/power ball/super ball made of material $b_2$.
lomatua	pipygau	$g_1=p_3=p_5$ bounces $p_1$ to $p_2$ reaching height $p_4$
fuaqleafıeq	pirlarfi'i	$f_1=p_3$ paints picture $f_2=p_1$ in style/art form $l_1$ representing/showing $p_2=f_4$ on medium $p_4$
peqjıaıtoq	plejaita'o	$t_1=j_1$ is a clipboard made of $t_2$ with clip $j_3$ for holding paper $j_2=p_1$
peqjeoqchuo	pleke'atci	$t_1$ is a hole punch.
peqtıaı	pleta'e	$x_1$ is a carton for contents $x_2$.
peqbıu	pletu'u	$x_1$ is a cardboard/paper tube of paper $x_2$
choqshoe	plicru	$x_1$ allows $x_2$ to use/employ $x_3$ for purpose $x_4$
choqkoe	plicu'a	$c_1=p_1$ adopts/selects/chooses/accepts  $c_2=p_2$ out of alternatives $c_3$ for purpose $p_3$.
choqdeq	plika'e	$x_1$ is able to use $x_2$ for purpose $x_3$ under conditions $x_4$.
choqıq	plikai	$x_1 = k_1 \approx p_2$ has functionality/utility/use features $x_2 = k_2 \approx p_2$ for purpose/in context $x_3 = p_3$
choqsıao	plikra	$x1=k1$ is a resource for $x2=p1$ to use
pıanetenuı	plinycma	$c_1=p_1$ is an asteroid/planetoid revolving around $p_2$ with characteristics $p_3$ and orbital parameters $p_4$.
pıanetechu	plinymidju	$x1$ is the planetary core of $x2$
pıanetedıu	plinyske	$x_1=s_1$ (mass of facts) is planetary science based on methology $x_2=s_3$.
choqca	pliri'a	$r_1=p_1$ applies $r_2=p_2$ to $r_3=p_3$.
choqreaq	plivei	$v_1$ is a log/record of data $v_2$ (nu/du'u) about $v_3=p_1$'s use of resource $p_2$ for purpose $p_3$ recorded in medium $v_4$.
choqgıtoa	plixauvla	$v_1$ is a useful word meaning/causing $v_2=x_1=p_2$, a meaning which is useful to $x_2=p_1$ for purpose $p_3$, in language $v_3$
notuqbuaq	po'afli	$f_1$ fails to explode; $f_1$ is a dud.
notuqlaq	po'asna	$x_1$ is an explosion sound made by $x_2$
notuqgıo	pojgu'i	$g_1=s_1$ is a flash of light at $g_2$ from source $g_3$
notuqmeı	pojma'a	$x_{1}$ is an explode-mountain with mountainous $x_{2}$.
chuebeotua	porcnegau	$x_1$ reorders / changes the order of $x_2$
chuefao	porfa'o	$x_1$ is a subsequence of $x_2$ located at the end of $x_2$ and $x_3$ elements long
chuelıaq	pormei	$x_1$ (sequence) has length $x_2$
boruaq	posxu'a	$x_1=p_1$ claims ownership of $x_2=p_2$ in condition $p_3$.
shuaqbeoq	pracmu	$j_1$ is capital (factors of production) used to create goods/services $j_2=c_2$.
poqmeaq	preblo	$b_1$ is a passenger ship for carrying $b_2$, propleed by $p_3$.
poqdoeme	preci'e	$x_1$ is a plural system in body $x_2$ with members/selves $x_3$.
poqdao	predatni	$d_1$ is a profile/are personal data of person $d_2=p_1$ gathered by method $d_3$.
poqlım	prejmi	$x_1$ understands/knows how $x_2$ (person) feels and why they do $x_3$ (ka)
poqchao	prekarce	$k_1$ is a private car/person car for carrying persons $k_2$, propelled by $k_3$.
poqraq	prera'a	$x_1$ is something personal about/pertaining to $x_2$ (person).
poqsheıjuao	prezi'ejva	$j_1$ is a human right for $z_1=p_1$ to do $z_2$ (event/state).
poqsheıtı	prezi'ezva	$j_1$ is a human right for $z_1=p_1$ to do $z_2$ (event/state).
pugaıcheu	prugastcica	$x_1$ (event) causes déjà-vu to $x_2$ (person) using sense $x_3$ under conditions $x_4$
pujaı	prugei	$x_1$ looks forward, is in joyful anticipation of $x_2$ (proposition) being the case.
puduatua	prujungau	$x_1$ predicts/foretells/anticipates to $x_2$ fact(s) $x_3$ (du'u) about subject $x_4$ by epistemology $x_5$.
puleaq	prula'i	$p_1=l_1$ is preceding $p_2=l_2$ in sequence $l_3$.
puleaqjue	prula'ima'i	$m_1=p_1=l_1$ is the previous month; $m_1=p_1=l_1$ is the month before $p_2=l_2$, month standard $m_3$.
puleaqnuaq	prulamcte	$n_1=l_1=p_1$ is the night before $p_2=l_2$ at location $n_3$.
puleaqchaq	prulamdei	$d_1=p_1=l_1$ is yesterday; $d_1=p_1=l_1$ is the day preceding/eve of $p_2=l_2$, day standard $d_3$.
puleaqjoa	prulamjeftu	$j_1=p_1$ is the week directly before $p_2$ by standard $j_3$.
puleaqnıaq	prulamna'a	$n_1=p_1=l_1$ is yesteryear; $n_1=p_1=l_1$ is the year preceding $p_2=l_2$ by year standard $n_3$.
pumıedıupoq	prumivyskepre	$x_1$ is a paleontologist
pumoaqbudeq	prumojnalka'e	$k_1$ is unable to/incapable of remembering past $k_2$ under conditions $k_3$. $k_1$ has retrograde amnesia/memory loss.
putoaıchumıe	pruslemijyji'e	$x_1$ is a prokaryote of species/defining property $x_2$.
pusıu	prusmi	$x_1$ beats $x_2$ to doing/being $x_3$ (ka).  $x_1$ did/was $x_3$ before $x_2$ did, who was trying to do the same thing.
puseo	pruspe	$s_1$ is the ex-wife/husband of $s_2$ under law/custom/tradition/system/convention $s_3$.
pualıe	pukfri	$x1=p2=l1$ enjoys $x2=p1=l2$
puade	pukmle	$x1=p1=m1$ is sweet/[pleasantly beautiful] to $x2=p2=m2$ under conditions $x3=p3$ by standard $x4=m4$
puajaq	puktce	$m_1=p_1$ delights $p_2$ under conditions $p_3$
puatua	pukygau	$x_1$=$g_1$ (agent) makes $x_2$=$p_1$ (event/state) pleasant to $x_3$=$p_2$ under pleasantness conditions $x_4$=$p_3$; $x_1$ pleases (one sense) $x_3$ with $x_2$ (event/state)
puleaqguo	purlamke'u	$x_1$ is the last time/previous time that $x_2$ happened.
pusı	purzga	$p_1=z_1$ previews $z_2$ by means $z_3$ under condition $z_4$.
raqlojı	ra'arlogji	$x_1$ is relevant logic / relevance logic, used to deduce/infer $x_2$ (du'u)
sheaqpeojeoq	rajgreke'a	$x_1=k_1$ is a shaft in $x_2=k_2=p_2$ to/between $x_3=p_3$ from/and $x_4=p_4$ permitting passage by $x_5=p_1$.
sheaqzıulıaq	rajnacmei	$x_1$ is a column vector of dimension $x_2$ with coordinates $x_3$, $x_4$, ...
sheaqpıorem	rajroksfe	$s_1=rs_1$ is a vertical rock face / rock surface of rock / mountain $rs_2$ on side $rs_3$ with edges $rs_4$, vertical in reference frame/gravity $s_2$.
sheaqbuaı	rajycla	$x_{1}$ is tall according to standard $x_{2}$.
sheaqpaq	rajypau	$x_1$ is a column/file of table/chart $x_2$.
sheaqpaqjeq	rajypaudu'i	$d_1$ is in the same column(s) as $d_2$, column(s) $pa_1=r_1$ is/are a part of whole/mass $pa_2$ in frame of reference $r_2$.
roadıu	rarske	$s_{1}$ is natural science with subject $s_{2} =r_{1}$ with methodology $s_{3}$.
roasheıjuao	rarzi'ejva	$z_1=r_1$ is a natural right for $z_1$ to do/be $z_2$ (event/state).
reqbua	re'azda	$z_1$ is a house for human being $z_2=r_1$.
nueqchuqnıu	recyctispa	$cit_1=s_1$ is a carnivorous plant of species $s_2$, eating meat from source/animal $r_2=cit_2$.
guoceo	refcfa	$c_1=k_2$ restarts for the $k_3$rd time.
guoceoca	refcfari'a	$r_1$ (event) restarts $c_1=k_2$ for the $k_3$rd time.
guozıqnua	refkibycpa	$c_1$ reloads $c_2=kr_2$ from $c_3=ki_1$.
guochue	refpoi	$x_1$ is a sequence made by repeating subpattern $x_2$ $x_3$ times.
guokuq	refsku	$c_1$ repeats/recapitulates $c_2$ (sedu'u/text/lu'e concept) to audience $c_3$ via expressive medium $c_4$, $k_3$ times (default:one).
guotua	refygau	$g_1$ redoes $g_2=k_2$ for the $k_3$th time.
reaqtua	rejgau	$g_1$ records / saves $r_2$ onto medium $r_4$.
gumoemteı	relcuktai	$t_1=c_1$ is a double circle.
gujaokaqchuo	reldarvistci	$t_1$ are binoculars for seeing $v_2=d_1$ which is far from $d_2$.
guchaq	reldei	$x_1$ is a Tuesday of week $x_2$ in calendar $x_3$.
guceoqjıeqpaq	reldicyjipypau	$x_1=p_1$ is a diode of $x_2=p_2$
gufaq	relfasnu	$x_1$ is binary.
gukopıtoa	relfu'ivla	$x_1=v_1=f_1$ is a stage 2 fu'ivla meaning $x_2=v_2$, based on word $x_3=f_2$ in language $x_4$.
gurıalaq	relkarsna	$x_1$ (sound, text) is a diphthong.
guzıulıaq	relnacmei	$x_1$ is a 2-dimensional vector with coordinates $x_2$ and $x_3$.
gupıanete	relplini	$p_1$ is the second closest planet (default is Venus if p2 is the Sun) revolving around $p_2$ (default is the Sun), with planetary characteristics $p_3$, orbital parameters $p_4$.
gushıaqkoı	reltu'edzu	$x_1$ walks bipedally
gucıu	relvi'i	$r_1=v_2$ defecates, "goes number 2" from source $v_3$ via means/route $v_4$
guseaı	relxalka	$x_1$ is a quantity of ethanol from source $x_2$
gusıoqchao	relxilkarce	$k_1=xi_2$ is a motorcycle/two-wheeled vehicle for carrying $k_2$, propelled by $k_3$
gusıoqchao	relxilma'e	$m_1$ is a bicycle/motorcycle carrying $m_2$ on surface $m_3$, propelled by $m_4$.
reqme	remgunma	$x_1$ is a crowd of humans $x_2$
reqnueq	remre'u	$x_1=rc_1$ is a quantity of/contains human flesh from human $x_2=rc_2=rm_1$
reqsıu	remsmi	$r_1$ is humanoid/man-like in quality $s_3$.
reqsıukea	remsmimi'i	$m_1=r_1=s_1$ is an automaton [mostly unintelligent android/humanoid machine] for purpose $m_2$.
reqpoaı	remtsi	$x_{1}$ is a seed with organism with seed-human $x_{2}$.
reqkaqreo	remvisyska	$x_1$ appears to be in the human-visible band of light, with specific color/hue/shading $x_2$ as perceived by $x_3$ under conditions $x_4$.
chuecaq	rensazri	$x_1$ drives/is a train driver/engineer of train $x_2$. 
chuecaq	rentro	$j_1$ is a trainmaster, managing $j_2$ in activity $j_3$ pertaining to a train of units $t_2$ for railroad $t_3$
hıeqbeaq	rerga'a	$g_1=r_2$ is a javelin made of $g_2$ thrown by $r_1$.
teoqkuna	retyju'a	$x_1$ is an interrogative sentence, a question.
rıtımarao	ri'irdansu	$d_1=s_1$ (individual, mass) performs a ceremonial/ritual dance for purpose/goal $r_2$, by custom/in community $r_3$, with form/rules $r_4$ to accompaniment/music/rhythm $d_2$.
rıtıbeaq	ri'irga'a	$g_1$ is a mace/[ceremonial staff] made of $g_2$ used for purpose $r_2$ by custom/in community $r_3$.
rıqkaqlıaı	ri'orkalvoi	$x_1$ is a Phantom, the green-eyed flying monster from Minecraft that attacks if you don't sleep at night.
rıqnıu	ri'ospa	$s_1=c_1$ is a green plant/viridiplantae/viridiphyta/chlorobionta/plantae sensu strictu of species/strain/cultivar $s_2$
muaodueq	ricfoi	$f_{1}$ is a forest with predominant tree species/cultivar $t_{2}$.
muaodueqdıu	ricfoiske	$s_1$ is silvology/study of forest(s)/wood(s) $f_1$.
muaodueq	rictu'a	$tu_1$ is a forest of $tr_1$.
muaosıaı	ricyblu	$x_1=c_1$ is resin  (hydrocarbon secretion) of plants $x_2=c_2=t_1$
muaotoa	ricyvla	$x1$ is a leaf of tree $x2$
muaobua	ricyzda	$z_1$ is a treehouse of/for $z_2$ on tree $t_1$ of species $t_2$.
aıpıloha	ridjinme	$x_1$ is a quantity of/contains/is made of cobalt (Co).
aıpıbumuoq	ridnarmro	$x_1$ is undead/a living-dead in mythology/folk-lore/culture $x_2$
aıpıdoqpoq	ridytorpre	$c_1=t_1=p_1$ is a little people [mythological being] of  mythology $c_2$ .
camoı	rikpei	$x_1$ causes $x_2$ by psychokinesis.
cazudıu	rikybauske	$s_1$ is the diachronics/diachronic linguistics of $s_2=b_1$.
paozu	rirbau	$b_1$ is the native language/"mother tongue" of $b_2=r_2$
paocıa	rircau	$x_1$ is an orphan
paoseo	rirspe	$x_1$ is the step-parent/step-mother/step-father of $x_2$ due to marriage with their parent according to law/custom $x_3$.
paoteıruo	rirtaitra	$x_1$ patronizes $x_2$; $x_1=t_1=r_1$ acts towards $x_2=t_2=r_2$ by doing $x_3=t_3$ as if $x_1$ was $x_2$'s parent.
tıashıaq	rixtu'e	$x_1$ is a hind leg or limb of $x_2$
tıakuoq	rixybo'u	$x_{1}$ is a bone-behind with bone function  $x_{2}$.
tıajaoshıaq	rixydartu'e	$x_1$ is the calf/lower back part of the leg (body-part) of $x_2$
pıohıeq	ro'inre'o	$re_{1}$ throws/launches/casts/hurls stones $ro_{2}$=$re_{2}$ to/at/in direction $re_{3}$.
pıosho	ro'irbi'o	$x_1$=$b_1$ becomes rock/is petrified/is fossilized/is transformed into a statue $x_2$=$r_1$=$b_2$ (result) of composition $x_3$=$r_2$ at/from location $x_4$=$r_3$ under condition $x_5$=$b_3$
pıopıanete	rokplini	$x_1$ is a rocky planet/terrestrial planet/'Earth', revolving around $x_2$ with planetary characteristics (possibly including rock composition) $x_3$ and orbital parameters  $x_4$
pıohıeq	rokre'o	$re_{1}$ throws/launches/casts/hurls stones $ro_{2}$=$re_{2}$ to/at/in direction $re_{3}$.
pıogugoa	rokrelca'u	$x1$ is a terrain characterized by rock $x2$
pıorem	roksfe	$s_1$ is a rock face / rock surface of rock / mountain $s_2=r_1$ on side $s_3$ with edges $s_4$.
pıoshotua	rokybixygau	$x_1$ =$g_1$ (agent) petrifies/turns/'freezes'/fossilizes $x_2$=$b_1$ into rock/fossil/statue $x_3$=$r_1$=$b_2$ (result) of rock composition $x_4$=$r_2$ and at/from location $x_5$=$r_3$ under conditions $x_6$=$b_3$.
tunuaq	rolcte	$x_1$ is every night
tuchaq	roldei	$x_1$ occurs daily
tulaochue	roldepre'e	$x_1$ is local train that stops every station of cars/units $x_2$ (mass) for rails/system/railroad $x_3$, propelled by $x_4$.
tuchaq	roldje	$x_1$ (nu) [typically] happens everyday
tujeq	roldu'i	$x_1$ is the same thing as $x_2$.
tufuaqkoe	rolxracu'a	$c_1$ selects all images containing $p_2$; $x_1$ completes a CAPTCHA
ruanıu	rulspa	$x_1=s_1=xr_2$ is an angiosperm/magnoliophyta/flowering plant of species $x_2=s_2$ with flower/blossom/bloom $x_3=xr_1$
zeopıu	rutcalku	$x1=c1$ is a husk of $x2=g1=c2$ of species $x3=g2$ composed of $x4=c3$
romkue	samcku	$c_1$ is an e-book containing work $c_2$ by author $c_3$ for audience $c_4$ stored in computer $s_1=c_5$.
rombeoq	samcmu	$x_1=j_1$ is an operating system for computer $x_2=j_2=s_1$.
rombeoqbeo	samcmuga'i	$x_1=s_1$ is a port/conversion to operating system/architecture $x_2=g_2=j_1$ from operating system/architecture $x_3=g_3=j_1$, ported by $x_4=g_1$
romkoe	samcu'a	$x_1$ clicks/selects $x_2$.
rombuaq	samfli	$f_1=s_1$ crashes while doing $f_2$ (state / event)
romcoe	samjo'e	Computer $j=1=s_1$ is connected to computer $j_2=s_1$ via medium $j_3$.
romcoetua	samjongau	$g_1$ (agent) connects computer $j=1=s_1$ to computer $j_2=s_1$ via medium $j_3$.
romtoaı	samka'u	$k1$ is an amount of computer elementary particles/smallest measurable increments of computer property/activity $k2$; k1 is a bit(s)
romıq	samkai	$c_1$ is characterized by computer properties; $c_1$ is digital.
romluaq	samkei	$k_1$ plays with computer/gaming system/gaming console $s_1$.
rombıq	samki'o	$k_1$ is 1024 ($2^{10}$) of $k_2$ in dimension/aspect $k_3$ (default is units).
rompeq	sample	$x_1$ is computer paper from source $x_2$ for computer/printer $x_3$.
romchoq	sampli	$p_1$ is a computer user / user of computer $p_2=s_1$ for purpose $p_3=s_2$.
rompoq	sampre	$x_1=s_1=p_1$ is a computer-person/robot with purpose $x_2=s_2$
romlueq	samse'u	$se_1=sk_1$ is a server [computer] serving client(s) [computer(s)] $se_2$ with service $se_3$ (activity).
romdıu	samske	$x_{1}$ is computer science with science methodology $x_{2}$.
romtoaı	samsle	$se1$ is an indivisible, most basic computer subunit unit of computer $se2$; se1 is a bit
romkeoı	samta'a	$t_1$ talks via computer to $t_2$ about $t_3$ in language $t_4$.
romchuo	samtci	$t_1$ is a computer program / tool / application for purpose $t_2=s_2$ on computer(s) including $s_1$.
romchuofıeq	samtcifi'i	$f_1$ programs [writes computer program] $f_2=t_1$ for function/purpose $f_3=t_2=s_2$ from existing elements/ideas $f_4$; $f_1$ is a programmer
romchuolueq	samtcise'u	$se_1=sk_1$ is a server [computer program] serving client(s) [computer program(s)] $se_2$ with service $se_3$ (activity).
romcaqchuo	samtrotci	$x1=tc1$ is a console for controlling computer $x2=s1=tr2$
rommuq	samxa'e	$xa_1$ is a pointing device for computer $xa_2=s_1$.
romfuaqtoq	samxrata'o	$x_1$ is a graphics tablet / digital drawing tablet for computer $x_2$
romsuechuo	samymi'etci	$x_1$ is a shell/REPL for controlling $x_2$.
rommoaq	samymo'i	$m_1=s_1$ (computer) loads [data] $m_2$.
romtı	samyzva	$z_1$ is logged on to computer $z_2=s_1$.
poıbadueq	sasfoi	$f_1$ is a lawn/meadow/field of grass species $s_2$.
poıbadueq	sastu'a	$t_1$ is a grassland/prairie/steppe in location $t_2$ with endemic grass species $s_2$
poıbasıunıu	sasysmispa	$s_1$ is a sedge (plant in family Cyperaceae) of species/strain/cultivar $s_2$.
caqgıamtua	sazmuvgau	$g_1=s_1$ [person/agent] steers/manoeuvres object/vehicle $m_1$ to destination/receiver $m_2$ [away] from origin $m_3$ over path/route $m_4$ by operating/driving machine/apparatus/vehicle $s_2$ (default: x2).
caqfa	sazykla	$x_1$ drives to $x_2$ from $x_3$ via $x_4$ by operating $x_5$.
caqshaı	sazysti	$x_1=sa_1=si_1$ [agent] ceases/halts/ends the operation of [apparatus/machine] $x_2=sa_2$ in aspect/function/process/activity $x_3=si_2$
taqjuoı	se'iski	$x_1$ describes / tells about themself to audience $x_2$ with self-description $x_3$.
taqcaq	se'itro	$j_1=s_2$ has self-control/good temper in regard of $j_3$ (activity/event/performance).
taqrıu	se'ixru	$xr_1=xr_2$ returns itself to state $xr_3$ from state $xr_4$.
lueqsho	se'urbi'o	$s_1=b_1$ (agent) volunteers/signs up to serve $s_2$ with service $s_3$ (activity) under conditions $b_3$.
joqhuageakuoq	sedgalbo'u	$b_1$ is a parietal bone (os parietale) performing function $b_2$ in body of $b_3$.
joqhuagaokuoq	sedgapybo'u	$b_1$ is a parietal bone (os parietale) performing function $b_2$ in body of $b_3$.
joqhuacıatua	sedycaugau	$g_1$ beheads $c_1=s_2$.
joqhuashaq	sedycra	$c_1$ is the forehead of $s_2$.
joqhuanoı	sedycro	$x_1$ has/feels a headache.
joqhuadea	sedyda'i	$x_1$ headbutts $x_2$.
joqhuakıaqcıa	sedykrecau	$c_1=s_2=c_2$ is bald.
joqhuafuq	sedyta'u	$x_1=t_1$ is a hat worn by/on the head of $x_2=t_2=s_2$ for purpose $x_3=t_3$.
joqhuatıakuoq	sedyti'ebo'u	$b_1$ is a occipital bone (os occipitale) performing function $b_2$ in body of $b_3$.
lueqtua	sefygau	$x_1$ enslaves $x_2$ to do service $x_3$
poerıe	seirbi'i	$x_1$ is the divide between $x_2$ and $x_3$; $x_1$ separates $x_2$ from $x_3$;
poecıa	sepcau	$s_1$ is immediately next to $x_2$.
poebua	sepxa'u	$x_1$ lives alone in home $x_2$
poegoeq	sepybi'u	$x_1$ is a screen separating $x_2$ from $x_3$
poetua	sepygau	$x_1=g_1$ separates/puts distance/barrier(s) between $x_2=s_1$ and $x_3=s_2$.
taqbuırıoq	sezbarkle	$x_1$ (metric space/set/class/structure) is a metric subspace/subset(/subclass) of $x_2$ (metric space/set/class) which is closed therein. $x_1$ is an closed subset of $x_2$, where closedness is taken to be understood as being considered within $x_2$ and under the metric shared by $x_1$ and $x_2$
taqjaotua	sezdargau	$x_1$ removes/distances themself from $x_2$ in property $x_3$ (ka).
taqgeatua	sezgalgau	$gas_1=s_1$ raises/elevates it/his/her self by in frame of reference $gal_2$ as compared with standard/baseline $gal_3$.
taqseaq	sezgle	$g_1=s_2$ masturbates/has sex without partner(s).
taqsıqja	sezlu'i	$x_1$ washes his/her/em/itself of dirt/contaminant $x_2$ in/with cleaning material(s) $x_3$.
taqchua	sezme'e	$c_1$ is an autonym (self-given name) of $c_2=c_3$.
taqdutua	sezmlugau	$g_1=se_2$ pretends to have property(ies) $si_2$ to observer $si_3$ under conditions $si_4$
taqhıeq	sezre'o	$r_1=s_2$  throws/launches/casts/hurls oneself to/at/in direction $r_3$.
taqrıerıoq	sezrurkle	$x_1$ is an open set in the topological space $x_2$.
taqıqmıu	sezykaiji'i	$x_1$ opines that they are/does $x_2$ (ka); $x_1$ identifies themselves with property $x_2$
taqmaı	sezypa'i	$x_1$ is a love-loved; $x_1$ is a narcissist
taqlueq	sezyse'u	$x_1=sel_1=sev_2$ is selfish/self-serving/egotistical in regard to activity $x_2=sel_3$. $x_1=sel_1=sev_2$ is an egotist.
taqpoetua	sezyseigau	$x_1$ separates/removes themself from $x_2$ by gap/interval/partition/barrier $x_3$.
taqjuoıjuo	sezyskinoi	$n_1$ is an autobiography/resumé/home page of $n_2$=$n_3$, intended for $n_4$.
taqjuoıtoa	sezyskivla	$x_1$ is an autonym (word that describes itself) meaning $x_2$ in language $x_3$
taqgıqcaq	sezytoltro	$j_1=s_2$ is out of control/temper of/with regard to $j_3$ (activity/event/performance).
taqruaq	sezyxu'a	$s_2=x_1$ (agent) self-affirms/claims/declares $s_1=x_2$ (du’u) is true about ones identity/self.
taqjeaq	sezyze'a	$s_1=z_1$ improves itself/is self-improving/augmenting/increasing in property/quantity $z_2$ by amount $z_3$.
nıaoruq	si'ercarvi	$c_1=s_1$ snows to $c_2$ from $c_3$.
nıaopuefuq	si'ercutci	$c_1$ is a snowshoe for covering/protecting feet/hooves $c_2$, and of material $c_3$.
nıaosoı	si'erda'a	$x_1$ engages in a snowball fight with $x_2$ over issue $x_3$, using snow/snowballs $x_4$.
nıaojıo	si'erdi'u	$d_1$ is an igloo for purpose $d_2$.
nıaoroınaoruq	si'erjoijaucarvi	$c_1=s_1=d_1$ sleets [rain with snow] to $c_2$ from $c_3$.
nıaofuaq	si'exra	$p_1=s_1$ is a snow sculpture/statue/[work of art made from snow] representing/depicting/showing $p_2$ made by artist $p_3$.
sıomoı	sibypei	$x_1$ (agent) thinks idea $x_2$ (si'o abstract) about subject $x_3$
cheosho	simbi'o	$x_1$ (plural) become mutual in property $x_2$ (ka).
cheosoı	simda'a	$x_{1}$ fight [each other] over issue $x_{2}$ (abstract).
cheopaı	simpe'o	$x_{1}$ are friends [of each other].
nuonoqtua	sipsavgau	$g_1=s_1$ snores.
nuochıa	siptcu	$x1=s1=n1$ is sleepy for reason $x2=n3$
nuoshao	sipydji	$d_1=s_1$ is drowsy/sleepy.
nuoceu	sipyva'u	$x1=s1=v1$ snores
reocıa	skacau	$x_1$ is colorless to observer $x_2$
reosıu	skasmi	$x_1$ resembles $x_2$ in color $x_3$
dıulua	skefi'a	$c_1$ is science/technology-oriented science fiction about plot/theme/subject $c_2$ by author $c_3$, based on science $s_1$.
dıukua	skeku'a	$x_1=k_1$ is a laboratory [room] for studying science $x_2=s_2$.
dıupoq	skepre	$p_1$ is a scientist pertaining to science $s_1$ about subfield $s_2$
nhoqchao	skoma'e	$m_1$ is an aerial tramway carrying $m_2$ in/on lift $m_3$, propelled by $m_4=s_1$.
nhoqnıu	skospa	$x_1$ is a vine of genus/species/variety $x_2$.
kuqshao	skudji	$d_1$ means/intends to say $c_2$ to $c_3$ via medium $c_4$.
kuqsue	skumi'e	$m_1=c_1$ expresses/states an order to $m_2=c_3$ for $m_3$ (event/state) to happen.
toaıjıo	sledi'u	$x_1$ is a room, building unit for purpose $x_2$
toaıchu	slemidju	$x_1$ is a nucleus of cell $x_2$ [default biological].
toaıpaq	slepau	$x_1=pagbu_1=selci_1$ is an irreducible/fundamental/indivisible part or constituent or unit which partially composes whole $x_2=pagbu_2$.
sıudu	smimlu	$siml_1=sims_1$ resembles/looks like/appears to be similar/parallel to $sims_2$ in property/quantity $sims_3$ to observer $siml_3$ under conditions $siml_4$
sıucheo	smisi'u	The members of $x_1=simx_1$ (set) resemble one another in property $x_2=simx_2$.
sıuruo	smitra	$x_1=t_1=s_1$ acts like/similarly to $x_2=t_2=s_2$ in property $x_3=s_3$ under conditions $x_4=t_3$.
mıudue	smudra	$x_1=d_1=s_1$ is semantically correct in situation/context $x_2=d_3$, having meaning $x_3=s_1$ according to interpreter $x_4=s_3=d_4$.
mıutua	smugau	$g_1$ refers to $s_1$ with expression $s_2$ recognized by $s_3$.
mıujuı	smujbi	$x_1$ (symbol/text) is close to $x_2$ (symbol/text) in meaning, as seen by $x_3$.
mıulım	smujmi	$x_1$ understands the meaning of $x_2$ that is introduced by $x_3$
mıusıo	smusi'o	$sm_1=si_1$ is the abstract meaning of $sm_2$ recognized/seen/accepted by $sm_3$ 
mıudıu	smuske	$sa_1$ is semantics with methodology $sa_3$.
mıukuq	smusku	$x_1$ expresses meaning $x_2$ to addressee/audience $x_3$ by doing $x_4$ (property of $x_1$)
laqkopıtoa	snafu'ivla	$x_1$ is an onomatopoeic word meaning $x_2$ in language $x_3$, based on sound $x_4$ emitted by $x_5$
laqlaı	snasni	$x_1$ is a sound/acoustic signal, produced/emitted by $x_2$ and meaning $x_3$ to $x_4$ (listener).
laqreaq	snavei	$v_1$ is a sound recording of $v_2$ (data/facts/du'u) about $v_3$ on recording medium $v_4$.
laqreaqchuo	snaveitci	$t_1$ is a microphone for recording sound $s_1$ produced/emitted by $s_2$.
laqsı	snazga	$x_1$ listens to $x_2$
laıbeo	snicne	$x_1$ is a variable taking value $x_2$ under conditions $x_3$.
laıtua	snigau	$x_1$ assigns symbol/variable $x_2$ to value/referent $x_3$ for observer $x_4$.
laılaı	snile'u	$x_1$ is an ideogram/symbol in writing system $x_2$ meaning $x_3$.
keoınua	snucpa	$x_1=s_1=c_1$ negotiates $x_2=s_2=c_2$ with $x_3=c_3$
keoırıaq	snustu	$s_1$ is a forum for $c_1$ to discuss/talk about topic/subject $c_2$.
shuokua	socku'a	$x_1=k_1=s_1$ is a closet/storeroom for materials $x_2=s_2$ in containment $x_3=s_3$ in home/building/structure $x_4=k_2$ surrounded by partitions/walls/ceiling/floor $x_5=k_3$ (mass/jo'u)
hoechaq	soldei	$x_1$ is Sunday of week $x_2$ on calendar $x_3$.
hoegıogıu	solgusli'i	$x1=l1$ is a sunbeam/sunray/[line of sunlight] illuminating $x2=g2$
hoenıu	solspa	$sp_1$ is a sunflower (genus Helianthus) of species/strain/cultivar $sp_2$.
hoenıupoaı	solspatsi	$t_1$ is/are (a) sunflower seed(s) of sunflower $sp_1=t_2$.
soıchemepaq	songripau	$x_1$ is an army company, a subdivision of army unit $x_2$ which serves country/nation/group $x_3$.
soıchemepaqtoaı	songripausle	$x_1$ is an army platoon, a subdivision of army unit $x_2$ which serves country/nation/group $x_3$.
soıchesoıchao	sonjamkarce	$k_1$ is an armoured personnel carrier propelled by $k_3$.
puızujoe	sorbaucre	$c_1$ is a polyglot, proficient in languages $c_2=b_1$.
puıseaq	sorgle	$x_1$ has sex with a lot of people; $x_1$ is a slut/a player
puıcoeteı	sorjontai	$t_1$ is a web-shape, manifested by $t_2$.
puıdua	sorju'o	$x_1$ is knowledgable about subject $x_2$ by epistomology $x_3$
puııq	sorkai	many things satisfy property $x_1$
puıtıeqgoa	sorlutca'u	$p_1=c_1$ is a maze (an area with many paths) occupied by $c_2$, with route(s) leading to exit $p_2$ from entrance $p_3$ via points including $p_4$ (set).
puılıaq	sormei	$x_1$ are numerous/many
puımaı	sorpa'i	$x_1=p_1$ is polyamorous/loves many people (romantic love implied), including, but not limited to, set $x_2=p_2$.
puınuojıo	sorsipydi'u	$d_1$ is a dormitory (building/place) where people $x_2$ (complete mass) sleep.
puıreo	sorska	$sk_1$ is/appears to be colorful/many-colored as perceived/seen by $sk_3$ under conditions $sk_4$.
puıtoaıjıaq	sorslemu'e	$x_1$ is a cellular automaton containing cells $x_2$ defined by rules $x_3$
puıteı	sortai	$x_1$ is polymorphic, has polymorphism
puıshıaq	sortu'e	$x_1$ is a myriapod
nıugoeq	spabi'u	$b_1$ is a hedge separating $b_2$ and $b_3$ in $b_4$ made of plants of species $s_2$.
nıudueq	spafoi	$f_{1}$ is a brush/shrubland [field of plants] with predominant plant species/cultivar $s_{2}$.
nıume	spagunma	$x_{1}$ is a jointly-plant with component of mass $x_{2}$.
nıucaqlıe	spatrofri	$s_1$ is an bee-orchid/spider orchid (genus Ophrys) of species/strain/cultivar $s_2$.
seoceorıtı	specfari'i	$r_1$ is a wedding ceremony marrying $x_2=s_1$ to $x_3=s_2$.
seoluo	spelanzu	$x_1$ is the family of the spouse of $x_2$, composed of members $x_3$ via bonds/connections $x_4$, where the spousal arrangement is in accord with law/custom $x_5$.
seopao	sperirni	$x_1$ is the parent-/mother-/father-in-law (parent of spouse) of $x_2$ according to custom/law $x_3$.
seocheo	spesi'u	$si_{1}$ is/are married couple(s) under law/custom/tradition/system/convention $sp_{3}$.
seoshaı	spesti	$x1$=$sp1$=$st1$ is divorced from $x2$=$sp2$ by law/convention $x3$=$sp3$
poıbadueq	srasyfoldi	$x_1$ is a lawn, meadow
rıekuoq	srubo'u	$s_1=b_1$ is a rib of $s_2=b_2$.
rıefa	srukla	$k_1=s_1$ comes/goes to $k_2$ from $k_2$ around $s_2$.
rıegıam	srumu'u	$m_1=s_1$ orbits $s_2$ in direction $s_3$ using orbit $m_4$.
rıefuq	sruta'u	$t_1=s_1$ is a scarf worn on body part $t_2=s_2$.
shaıtua	stigau	$g_1$ stops $s_1$ from doing $s_2$
shaıbuseo	stinalspe	$x1$=$sp1$=$st1$ is divorced from $x2$=$sp2$ by law/convention $x3$=$sp3$
shaıca	stiri'a	$x_{1}$ is a cause with cease $x_{2}$ with causation conditions $x_{3}$.
shaıseo	stispe	$x1$=$sp1$=$st1$ is divorced from $x2$=$sp2$ by law/convention $x3$=$sp3$
rıaqchua	stucme	$c_{1}$ (quoted word(s)) is a/the place name [inherent/inalienable site/place/position/situation/spot/location] of $c_{2}$=$s_{1}$ to/used-by namer/name-user $c_{3}$ (person).
rıaqchuatoa	stucmevla	$v_{1}$  is a word derived from place name/toponym $c_{1}$ (quoted word(s)) meaning/causing $v_{2}$ in language $v_{3}$.
rıaqchoq	stupli	$pilno_1$ uses place / location $pilno_2=stuzi_1$ for purpose $pilno_3=stuzi_2$; $x_2$ is a place / site for purpose $x_3$ used by $x_1$
gıaogueq	sudbu'u	$x_1$ is a towel
gıaotua	sudgau	$g_1$ dries/dehydrates $s_1$,  removing liquid  $s_2$
gıaoloqhaqbaı	sudglajukpa	$x1=j1$ bakes/[cooks by dry heating] $x2=s1=g1=j2$
gıaoshoemfuq	sudjirta'u	$t_1$ is a dry suit for wearing by $t_2=j_1=s_1$ in liquid $j_2$.
gıaohaqbaı	sudjukpa	$j_1$ (agent) dry roasts food-for-eating $j_2$ by recipe/method $j_3$ (process).
gıaodueq	sudytu'a	$t_1=s_1$ is a desert with land location  $t_2$.
suaıfa	sutkla	$s_1=k_1$ quickly comes/goes to destination $k_2$ from origin $k_3$ via route $k_4$ using means/vehicle $k_5$.
suaıgıam	sutmu'u	$m_1=s_1$ (object) quickly moves to destination/receiver $m_2$ [away] from origin $m_3$ over path/route $m_4$.
suaıjarashuao	sutybajycpi	$x_1$ is a roadrunner of species $x_2$.
suaıtıeq	sutydargu	$x_1$ is a freeway/motorway/expressway to $x_2$ from $x_3$ with route $x_4$
suaıshao	sutydji	$d_1$ is eager/impatient for $d_2=s_2$ to happen.
suaıtua	sutygau	$g_1$ hurries/rushes/speeds $s_1$ to do/be/bring about  $s_2$.
suaıjıaı	sutyjai	$x1=s1=j1$ grabs $x2=j2$ with $x3=j3$ at locus $x4=j4$
suaıjeaq	sutyze'a	$z_1=s_1$ accelerates/[speeds up] at doing/being/bringing about $s_2$ (event/state) by amount $z_3$.
keoıcheo	ta'arsi'u	$s_1$ (set) discuss subject $t_2$ in language $t_4$.
keoıkuq	ta'asku	$x_1$ (entity) talks about $x_2$ (entity) to $x_3$ (entity); $x_1$ (entity) speaks to $x_3$ (entity) about $x_2$ (entity)
keoınoq	ta'avru	$x_1$ is talking noise / background chatter to $x_2$ observed via senses $x_3$ of $x_4$ talking to $x_5$ about $x_6$ in language $x_7$.
toqrom	ta'orskami	$x_1$ is a tablet computer for purpose $x_2$
fuqsıqjakea	taflumca'a	$c_1$ is a washing machine.
teıceu	tairva'u	$v_1=t_1$ pants because of tiring effort/situation $t_2$ (event).
teımarao	tamdansu	$x_1$ dances to music $x_2$, with choreography/pattern $x_3$
teıtua	tamgau	$g_1$ defines $t_2$ into form $t_1$.
teıseaqlıe	tamglefri	$x_{1}$ is an experience-copulate with happening-shape $x_{2}$.
keoımuo	tavmu'o	$x_1$ has finished talking to $x_2$
keoıcheo	tavysi'u	$x_1$ talk to each other about $x_2$ in language $x_3$
doaqshuao	tcacpi	$c_1$ is a pigeon of subspecies $c_2$.                                                            
doaqcue	tcatru	$tu_1$ is the mayor of $tu_2=tc_1$.
jaqnoıtua	tcecrogau	$g_1$ (person/agent) tortures/inflicts severe pain on $x_2=c_1$ at locus $x_3=c_2$.
jaqjaı	tcegei	$g_1$ is delighted/ecstatic/overjoyed about $g_2$ (event/state).
jaqbuchoqhuı	tcenarplixla	$x_1$, when used for purpose $x_2$, is obsoleted in favour of $x_2$.
jaqpu	tcepru	$x_1$ (object/thing) is ancient.
jaqpuguobe	tceprubakni	$b_1$ is a aurochs/urus/ure (Bos primigenius) of variety/breed $b_2$.
jaqpudıu	tcepruske	$x_1$ is archeology of/about subject matter $x_2$ based on methodology $x_3$.
chuoıq	tcikai	$c_1=t_1$ is practical, likely to be applicable to event $c_2=t_2$.
daqmoabeo	tcikyga'i	$x_1$ reschedules from time $x_2$[hours, {minutes}, {seconds}] state/event $x_3$ to time $x_4$[hours, {minutes}, {seconds}]. 
daqmoatua	tcikygau	$g_1$ schedules time $t_1$ [hours, {minutes}, {seconds}] for state/event $t_2$ on day $t_3$ at location $t_4$.
chuosue	tcimi'e	$x_1$ (agent) sets / configures $x_2$ (machine/tool) to do $x_3$ (state/event/ka-of-$x_2$)
chuobaı	tcizba	$z_1$ makes tool $z_2=t_1$ for purpose $t_2$ out of $z_3$; $z_1$ implements $t_2$
chıabıa	tcubi'a	$x_1$ is addicted to doing $x_2$ (property)
chıamıe	tcuji'e	$n_1=j_1$ is a parasite on $n_2$.
daqpu	teipru	$x_1$ is in the past of/earlier than/before $x_2$ in time sequence, separated by an interval of $x_3$
daqchufaq	teirmijyfau	The elapsed time/duration between $x_1$ (nu, or time-/date-stamp) and $x_2$ (nu, or time-/date-stamp) is equal to the elapsed time/duration between $x_1$ and $x_3$ (nu, or time-/date-stamp), such that $x_2$ occurred no later than $x_3$ (thus, $x_1$ is also a temporal midpoint between them), in frame of reference $x_4$.
daqbıe	tembalvi	$x_1$ is in the future of/later than/after $x_2$ in time sequence, separated by an interval of $x_3$
daqrıe	tembi'i	$j_1=t_2$ (point in time) is near/approximates $j_2=t_3$ (point in time).
daqnuaı	temdi'i	$j_1=t_2$ (point in time) is near/approximates $j_2=t_3$ (point in time).
daqmute	temfesti	 $f_1$ is a ruin that has decayed from time/event $t_2$ to time/event $t_3$
daqpu	tempru	$x_1$ is in the past of/earlier than/before $x_2$ in time sequence, separated by an interval of $x_3$
daqpoecıa	temsepcau	$c_1=s_1$ is immediately next to $s_2$ in time.
teacıa	tepcau	$x_1$ is fearless/intrepid
tıafa	ti'ekla	$k_1$ withdraws to $k_2$ from origin $k_3=t_2$ via route $k_4$ using means/vehicle $k_5$.
tıasho	ti'erbi'o	$b_1$ gets behind $t_2$.
tıakıao	ti'evro	$v_1=c_1$ is a back door/gateway/access between $v_2$ and $v_3$ of structure $v_4$.
cheupoq	ticpre	$x_1$ is a humbug/trickster deceiving $x_2$
cheufuq	ticta'u	$ta_1$ is a disguise/camouflage worn by $ta_2$ to deceive $tc_2$ into $tc_3$.
huosoachuo	tinydjutci	$s_1=tu_1$ is a tool that aids $s_2=ti_1$ in hearing $ti_2$.
huochuo	tinytci	$x_1$ is a headphone/earphone/earbud/hearing aid/hearing device for hearing $x_2$ against background noise $x_3$, the device being of form $x_4$.
gıqsuoı	tolba'i	$b_1$ is low/inferior/abject in property $b_2$ (ka) by standard $b_3$.
gıqcıa	tolcau	$x_1$ has/is with $x_2$
gıqceo	tolcfa	$c_1$ [state/event/process] concludes/ceases/stops/ends its occurrence.
gıqceobıe	tolcfabalvi	$x_1$ (event) happens in the aftermath of $x_2$; $x_1$ happens after the end of $x_2$
gıqceotua	tolcfagau	$g_1$ stops/ends $c_1$ [state/event/process].
gıqceorıtı	tolcfari'i	$r_1$ is/are the ritual/proceedings for adjourning/ending $c_1$[event/state/process] by community $r_2$ with rules $c_4$.
gıqnıo	tolci'o	$c_1$ is old (opposite of young) by standard $c_2$.
gıqnıojeaq	tolci'oze'a	$x1=c1=z1$ grows old by amount $x2=z3$
gıqpuaıtua	tolcicygau	$g_1$ tames/domesticates $c_1$
gıqpuaı	tolcilce	(adjective:) $c_1$ is tame / “un-wild”.
gıqtıshaı	tolcliva	$x_1$ arrives at $x_2$ via route $x_3$
gıqnua	tolcpa	$c_1$ leaves $c_2$, which they brought, at $c_3$
gıqdaı	tolcu'i	$c_1$ (event/state/property) is impossible under condition $c_2$.
gıqshao	toldji	$x_1$ is reluctant/unwilling/disinclined to $x_2$ for purpose $x_3$.
gıqsoa	toldju	$x_1$ frustrates / hinders $x_2$ from doing event/activity $x_3$; $x_1$ makes doing $x_3$ harder for $x_2$
gıqdue	toldra	$d_1$ is wrong in property/aspect $d_2$ (ka) in situation $d_3$ by standard $d_4$.
gıqduelojı	toldralogji	$x1$ [rules/methods] is a logical fallacy for deducing/concluding/inferring/reasoning to/about $x2$ (du'u)
gıqdueteı	toldratai	$tarmi_2$ is warped/distorted/misshapen/malformed
gıqduetoa	toldravla	$x_1=v_1$ is a misnomer indicating $x_2$ in language $x_3$
gıqfao	tolfa'o	$x_1$ is a beginning of thing/process $x_2$
gıqshua	tolfa'u	$f_1$ rises to $f_2$ from $f_3$ in gravity well/frame of reference $f_4$.
gıqshuafa	tolfalkla	$k_1=f_1$ comes/goes against stream/current/gravity/force to destination $k_2=f_2$ from origin $k_3=f_3$ in in gravity well/frame of reference $f_4$ via route $k_4$ using means/vehicle $k_5$.
gıqfaq	tolfau	$x_1$ (event) is an event that doesn't happen/occur/take place
gıqfaqdaı	tolfaucu'i	under conditions $x_2$, it is possible that $x_1$ (event/state/property) doesn't happen
gıqfaqgıqdaı	tolfautolcu'i	under conditions $x_2$, it is not possible that $x_1$ (event/state/property) doesn't happen / $x_1$ necessarily happens
gıqjaı	tolgei	$g_1$ is gloomy/downcast/unhappy about $g_2$ (event/state).
gıqjaıjaq	tolgeitce	$m_1=g_1$ is miserable/in dispair about $g_2$ (event/state).
gıqjıaı	toljgari	j$_1$ lets go/releases $j_2$ from $j_3$ (part of j1) at locus $j_4$ (part of j2).
gıqsı	tolju'i	$x_1$ avoids/ignores/directs attention away from object/affair $x_2$.
gıqıq	tolkai	$x_1$ is characterized by the polar opposite of $x_2$ (ka)
gıqchı	tolkri	$x_1$ disbelieves/rejects $x_2$ as false about $x_3$.
gıqtıao	tolmapti	$m_1$ is incompatible with $m_2$ in aspect $m_3$.
gıqmoıchujoe	tolmencre	$c_1=m_2$ (person) is unintelligent/dumb/stupid by standard $c_3$.
gıqde	tolmle	$x_{1}$ is ugly to $x_{2}$ in aspect $x_{3}$ (ka) by aesthetic standard $x_{4}$.
gıqdejaq	tolmletce	$m_1=t_1$ is hideous/grotesque to $t_2$ in aspect $t_3$ (ka) by aesthetic standard $t_4$.
gıqmoaq	tolmo'i	$m_1$ forgets fact/memory $m_2$ about subject $m_3$.
gıqcho	tolnei	$x_1$ dislikes $x_2$
gıqnıq	tolni'o	$x_1$ is old (un-novel) to observer $x_2$ in feature $x_3$ (ka) by standard $x_4$
gıqruaıca	tolnolri'a	$x_1=r_1$ abases (to lower so as to hurt feelings) $x_2=r_2=n_1$
gıqchoqgı	tolplixau	$x_1$ is worse than useless to agent $x_2$ by the standard of purpose $x_3$
gıqpua	tolpu'a	$p_1$ (event/state) seems unpleasant to $p_2$ under conditions $p_3$.
gıqca	tolri'a	$x_1$ (event/state) effects/physically causes the negation of $x_2$ (event/state). $x_1$ prevents $x_2$.
gıqtaqcaq	tolse'itro	$j_1=s_2$ is out of control/temper of/with regard to $j_3$ (activity/event/performance).
gıqshaı	tolsisti	$x_{1}$ [agent] begins activity/process/state $x_{2}$.
gıqseo	tolspe	$x_1$ is a bachelor / single / unmarried.
gıqshaı	tolsti	$x_{1}$ [agent] begins activity/process/state $x_{2}$.
gıqjaq	toltce	$x_1$ is little/limited in property $x_2$ towards $x_3$.
gıqruaq	tolxu'a	$x_1$ (agent) denies that $x_2$ (du'u) is true.
gıqlaqcaı	tolylau	$x_1$ is soft/quiet/making only a bit of noise, at observation point $x_2$ by standard $x_3$.
gıqtıshaı	tolyli'a	$c_1$ arrives at $c_2$ via route $c_3$.
doqaıpı	torcrida	$c_1$ is a dwarf of mythos/religion $c_2$, short by measurement standard $t_3$.
doqpoq	torpre	$t_1=p_1$ is a dwarf/midget [short in stature resulting from a medical condition; not not necessarily human] by standard $t_3$.
doqdaq	tortei	$t_1$ is a short time/duration/interval/period/elapsed time from time/event $t_2$ to time/event $t_3$.
metadoeme	treci'e	$x_1$ is the metric system with relations $x_2$ among units $x_3$ and properties $x_4$.
caqbuaq	trofli	$f_1=j_1$ fails to control $j_2$ in $j_3$ (activity/event/performance).
caqtucuedoeme	troroltruci'e	$c_1$ is a totalitarian system in $j_2$ with power exercised by $t_1=t_1$
cuecıa	trucau	$c_1$ is an anarchy/is anarchic
cuecıasıo	trucausi'o	$x_1$ is an anarchist ideology as applied/practiced in/among people/territory/domain $x_2$ based on the works of thinker(s) $x_3$
cuejıao	trucei	$x_1$ is the lord-god of people/religion $x_2$ with dominion over sphere $x_3$
cuedoeme	truci'e	$c_1=t_1$ is the government of organizational type $c_2$ of people/territory/domain/subjects $t_2$ displaying properties $c_4$.
cuedoemerıe	truci'ebi'i	$j_1$ is intergovernmental / takes place where the decision-making power is shared among $j_2=t_1=c_1$ (governments).
cuetue	trucu'u	$c_1$ is a political affair involving $c_2$
cuetuepoq	trucu'upre	$x_1$ is a politician, involved in politics / political affair $x_2$
cueshaome	trudjigri	$g_1=d_1=t_1$ is a political party operating in territory $t_2$ with members $g_3$
cuepaq	trupau	$p_1$ is a government ministry/department responsible for $t_2$.
cuepaqjoaq	trupauja'a	$r_1$ is the minister/secretary of ministry/department $t_2$
cuepaqtoaı	trupausle	$s_1$ is a sub-division of the Ministry/Department of  $t_2$.
cuesıo	trusi'o	$s_1$ is a political ideology about $t_1$ ruling $t_2$ based on the work of thinker $s_3$
cueseo	truspe	$x_1$ is married to the governor/ruler of $x_2$ according to custom $x_3$; $x_1$ is first lady/prince consort/queen consort of $x_2$.
cuedoaq	trutca	$tc_1=tu_1$ is the administrative capital (seat of government) of $tu_2=tc_3$ located in $tc_3$
caıtuabeaq	tsagauga'a	$x1$ is a rebar [shape/form] of material $x2$
caıchao	tsakarce	$k_1=t_1$ is a jeep/land rover propelled by $k_3$.
caımoı	tsapei	$p_1=t_1$ meditates (thinks hard; possibly with psuedo-religious motivation) on subject concept $p_2$.
caımoı	tsapensi	$p_1=t_1$ meditates (thinks hard; possibly with psuedo-religious motivation) on subject concept $p_2$.
tuıfa	tsekla	$x_1$ rides on $x_2$ to $x_3$ from $x_4$ via $x_5$
tuırıaq	tsestu	$s_1=z_2$ is a seat for $s_2=z_2$.
poaınıu	tsispa	$x_1=t_2$ is a spermatophyte/phanerogam producing seed(s) $t_1$, of species/strain/cultivar $s_2$
bıugıe	tu'urbirka	$b_1 = t_1$ is a tentacle / tube-shaped arm [body part] of $b_2$.
bıucıe	tu'urfi'e	$f_1$ is a pipefish of genus/species $f_2$
bıunıu	tu'uspa	$x_1$ is a vascular plant
dueqpeo	tumgre	$x_1=p_1$ is cross-country of/crosses terrain $x_2=p_2=t_1$ to destination side $x_3=p_3$ from origin side $x_4=p_4$.
dueqrunaotıao	tumjvejaumapti	$x_1$ is amphibious (adapted for both land and water) in property/aspects $x_2$.
dueqrem	tumsfe	$s_1$ is the ground of land $s_2=t_1$ at location $t_2$.
dueqremguq	tumsfeni'a	$c_1$ is/are underground/subterranean beneath ground $t_1=s_1=c_2$ in frame of reference $c_3$.
dueqnıu	tumspa	$s_1$ is a land plant/embryophyta/metaphyta/plantae sensu strictissimo of species/strain/cultivar $s_2$ at location $t_2$.
dueqmıeq	tumymre	$m_1$ surveys $t_1$=$m_2$ as $m_3$ (map or measurements) in unit $m_4$ with accuracy $m_5$
shıaqpuefuq	tupcutci	$c_1$ is a boot for covering/protecting leg $c_2=t_1$, and of material $c_3$.
suaosoıche	vairsoi	$s_1=v_1$ is a military officer in army $s_2$.
rıogıamtua	varmuvgau	$mg_1$ is a fan blowing/moving air $mg_2=v_1$ to/towards/onto $mg_3$ from $mg_4$.
rıogıamkea	varmuvmi'i	$mi_1$ is a fan for moving air to destination $mu_2$ from origin $mu_3$ over path/route $mu_4$.
rıosoıche	varsoi	$s_1$ is an airman in army/air force $s_2$
rıonaomı	varxamsi	$x_1$ is the atmosphere of planet $x_2=v_2$ (default Earth) of composition $v_3$.
rıonaomıdıu	varxasyske	$s_1$ is the atmospheric science of planet x2.
ceuguqshoem	vaxni'ajinru	$j_1=c_1=v_1$ (object/person) is scuba diving beneath/below/under from $c_2$ (object/water surface) in frame of reference $c_3$ breathing/respiring $v_2$ [gas], submerged in liquid $j_2$.
ceuguqshoempoq	vaxni'ajirpre	$p_1=v_1$ is a scuba diver breathing gas $v_2$.
ceubıu	vaxtu'u	$x_1$ is the trachea of $x_2$
ceusoakea	vaxydjuca'a	$x_1=c_1=s_1$ is a ventilator for helping $x_2=s_2$ to breath
reaqtoaı	veisle	$x_1$ is a record cell or field containing data $x_2$, part of record $x_3$
reaqgıa	veisri	$x_1=d_1=v_4$ is a signal recording and playback tape-type medium (cassette/DAT/tape drive) containing data/sound/image $x_2=v_2$ with data storage mechanism/method x3 (analog/digital)
deoguobe	verbakni	$b_1=c_1$ is a stirk/yearling [young cattle/beef-producer/bovine], of age $n_2$, immature/defined as a stirk/yearling by standard $n_3$, of species/breed $b_2$.
deocıe	verfi'e	$x1$ is a fry/whitebait of species $x2$
cıukua	vimku'a	$x_1=k_1$ is a loo/water closet/[room with toilet], in which $x_2=v_1$ excretes $x_3=v_2$, in home/building/structure $x_4=k_2$ surrounded by partitions/walls/ceiling/floor $x_5=k_3$ (mass/jo'u)
cıukuarıaq	vimkumstu	$s1=k1$ is an inherent/inalienable room of excretion.
kaqdaı	visycu'i	$x_1$ is visible to $x_2$ under conditions $x_3$
kaqtua	visygau	$x_1$ makes $x_2$ see (perceive visually) $x_3$ under conditions $x_4$
toazujuaorıoq	vlagenkle	$x_1$ is the part-of-speech / grammatical class of word $x_2$, which means or has function $x_{3}$ in language $x_{4}$.
toagaqcheo	vlakansi'u	$x_1$ is a set of words that occur together meaning $x_2$ in language $x_3$; $x_1$ is a collocation
toarıoq	vlalei	$k_1$ is a word type within (language) $k_2=v_3$, with defining property $k_3$ (ka).
toalaıchue	vlalerpoi	$x_1$ is the spelling of the word $x_2$ in script/orthography $x_3$ // $x_1$ is a character string representing word $x_2$.
toalaıchuedoeme	vlalerpoici'e	$x_1$ is a script/orthography for language $x_2$
toagıufao	vlali'ifa'o	$x_1$ (se'e?) is a line terminator (eg \n, CRLF, ...) of file(s) $x_2$
toalıaq	vlamei	$x_1$ is text consisting of words $x_2$ meaning $x_3$ in language $x_4$.
toaburıtı	vlanalri'i	$x_1=v_1=r_1$ is a slang/informal word meaning $x_2=v_2$ in language $x_3=v_3$.
toachue	vlapoi	$x_1$ is a text, a sequence of words
toachuedoeme	vlapoici'e	$x_1$ (text) is an idiom, set phrase, idiomatic expression, phrasal idiom of sequence of words $x_2$ (text) with the formative feature $x_3$ (property of $x_1$)
toateı	vlatai	$t_1$ is the pattern/shape of word $v_1=t_2$ with meaning $v_2$ in language $v_3$.
lıaıfa	voikla	$k_1=v_1$ flies to destination $k_2$ from origin $k_3$ via route $k_4$ using means/vehicle $k_5=v_2$.
lıaıpeq	voiple	$x_1$ is a paper airplane/glider of paper $x_2$
choalaqlaq	voksna	$x_1$ is a vocal sound (vowel, consonant...)
choalaqlaqdıu	voksnaske	$s_2$ is phonetics based on methodology $s_2$.
choalaqkeoı	vokta'a	$x_1$ speaks (vocally) to $x_2$ about $x_3$ in language $x_4$
choalaqzujuaotoaı	vokygenkantu	$k_1$ is a minimal phonological feature of language $k_2=g_2$.
choalaqzujuaodıu	vokygenske	$s_1$ is phonology based on methodology $s_3$.
lıaıgıqdeqshuao	voltolka'ecpi	$x_1$ is a bird which is essentially incapable of sustained flight, of taxon $x_2$
jochaq	vondei	$x_1$ is a Thursday of week $x_2$ in calendar $x_3$.
jokopıtoa	vonfu'ivla	$x_1=v_1=f_1$ is a stage 4 fu'ivla meaning $x_2=v_2$, based on word $x_3=f_2$ in language $x_4$.
jopıanete	vonplini	$p_1$ is the fourth closest planet (default is Mars if p2 is the Sun) revolving around $p_2$ (default is the Sun), with planetary characteristics $p_3$, orbital parameters $p_4$.
kıaotıeq	vorlu'a	$p_1=v_1$ is a passage between $p_2=v_2$ and $p_3=v_3$.
kıaorea	vrokoi	$k_1=v_1$ is the threshold defining access through the boundary between $k_2=v_2$ and $k_3=v_3$.
kıaorıaq	vrostu	$x_{1}$ is a site with sited-door $x_{2}$.
noqkea	vruca'a	$c_1$ is a horn/buzzer/siren producing strident noise $c_2=s_1$, operated by $c_3$.
noqtuao	vrumli	$m_1=s_1$ is a squeak/creak/quiet noise to $s_2$.
buasho	xa'urbi'o	$b_1=xa_1$ settles in $xa_2$
tuaıshokoaq	xadbixma'u	$xa_2=b_1=m_1$ is adolescent/pubescent/in puberty/maturing in physical/bodily development-quality $m_2$ (ka).
tuaıchu	xadmidju	$x_1=m_1$ is the waist  of  $x_2=m_2$.
tuaıbuaı	xadycla	$c_1=xa_1$ is tall / has a long body by standard $c_3$.
tuaıluaqdoeme	xadykelci'e	$c_1$ is/are a/the physical sport(s) exercised/played by $x_2$.
tuaıpaq	xadypau	$x_1$ is a part of $x_2$'s body
gıbeo	xagyga'i	$x_1=g_1$ modifies $x_2=g_2$ into $x_3=g_3=xag_1$ for the benefit of $x_4=xag_2$.
gıjeaqtua	xagzengau	$g_1$ (agent) improves $z_1=x_1$ for $x_2$ by amount $z_3$.
gıjeaqca	xagzenri'a	$r_1$ (event/state/process) improves $z_1=x_1$ for $x_2$ by amount $z_3$ under conditions $r_3$.
hıaokue	xaicku	$x_1$ is a book damaged by/website attacked by $x_2$ in property $x_3$ (ka).
hıaotua	xairgau	$g_1$ causes event $x_1$ which injures/harms/damages victim $x_2$ in property $x_3$ (ka) resulting in injury $x_4$ (state).
seaııq	xalkai	$xa_1=c_1$ is alcoholic of alcohol type $xa_2$ from source/process $xa_3$.
seaıcabıa	xalri'abi'a	$x_1$ has a hangover (alochol-induced illness) with symptoms $x_2$
muqkıoq	xanboi	$x_{1}$ is a ball with ball material $x_{2}$.
muqcheıjıeq	xandegji'o	$x_1$ is a fingertip of finger $x_2$ of hand $x_3$ of body $x_4$
muqcheıpıu	xandegycalku	$c_1$ is a fingernail of finger $c_2=d_1$ of body $d_3$.
muqnuaı	xandi'i	$x_1$ is cash
muqjıaıcheo	xanjaisi'u	$s_1$ hold hands/are hand-in-hand.
muqlaılaı	xanle'ule'u	$xl_{1}$ (la'e zo BY/word-bu) is a fingerspelling sign in character-set of sign language/system of manual communication $xl_{2}$ representing letter/digit/symbol $xl_{3}$=$l_{1}$ in written alphabet/character-set $xl_{2}$ performed by hand(s) $xl_{4}$.
muqguq	xanyni'a	$x_1$ is the palm (body-part) of $x_2$
naomıguq	xasni'a	$x_1$ is under sea $x_2$ in reference frame $x_3$.
naomıhaq	xasydja	$x_1$ is seafood of ingredients/contents $x_2$ of variety/type $x_3$ from sea/ocean/gulf/fluid body $x_4$
naomıdıu	xasyske	$s_1$ is the oceanography/marine science of planet $x_2$.
naomıpoıba	xasysrasu	$s_1$ is a blade/expanse of seagrass (from families Posidoniaceae, Zosteraceae, Hydrocharitaceae, or Cymodoceaceae) of species/strain $s_2$.
gıjaq	xautce	$x_1=m_1$ (object/event) is excellent/very good/beneficial for $x_2$ by standard $x_3$.
sıoqsoıchao	xiljamkarce	$k_1$ is a military armoured car propelled by $k_3$.
sıoqgıam	xilmu'u	$x_1$ moves on wheel(s) to location $x_2$ from location $x_3$
sıoqtoq	xilta'o	$t_1$=$xi_1$ is a board with wheels/skateboard/longboard/snakeboard [default skateboard], of material/property $t_2$ with wheels [material/property] $xi_3$.
ekushoı	xircmo	$c_1$ neighs.
ekucheılıaq	xirdegmei	$m_1$ is a mass of set $m_2$ with an odd number of members $m_3$
ekucheızıu	xirdegna'u	$x_1$ is an odd number (integer not divisible by 2)
ekuruaı	xirno'i	$x_{1}$ is a noble with conferred nobility order $x_{2}$.
ekusoıche	xirsoi	$s_1$ is a horse cavalryman of army $s_2$.
ekunueq	xiryre'u	$r_1$ is horse meat from species/breed $r_2=xi_2$.
ekubua	xirzda	$z_1$ is a stable for horse/equine/[colt/mare/stallion/pony] $z_2=x_1$ of species/breed $x_2$
huıhaq	xladja	$xl_1=c_1$ is bad food/junk food (in one sense) for $xl_2=c_2$, bad by standard $xl_3$.
huıpoq	xlapre	$x_1=p_1=xl_1$ is a bad/poor performing person for task $x_2=xl_2$ by standard $x_3=xl_3$
huıjaq	xlatce	$x_1$ is terrible for $x_2$ in aspect  $x_3$
fuaqteı	xratai	$t_1=p_1$ is an image of $t_2=p_2$ created by agent $p_3$ on medium $p_4$.
rıuhıe	xrubei	$b_1=x_1$ takes/carries back $b_2=x_2$ to origin/earlier state $b_3=x_3$ from $b_4=x_4$ over path $b_5$.
rıusue	xrucpe	$c_1$ requests/asks $c_2$ to go back/return to $x_2$ from $x_3$.
rıuhaq	xrudja	$x_1$ is cud/cecotrope/re-eaten food for $x_2$ (ruminant/rabbit) that began as $x_3$
seaobeoq	xu'icmu	$x_1$ is an element of compound $x_2$.
seaotoaı	xumsle	$s_1$ is a molecule of chemical $x_2$.
seaosuaıca	xumsutri'a	$r_1=x_1$ catalyzes chemical reaction $r_2=s_2$ under conditions $r_3$.
kıabao	xunblabi	$b_1=x_1$ is pink.
ruaqlıemoaq	xusfrimo'i	$x_1$ remembers hearsay $x_2$
ruaqlojı	xuslogji	$l_1$ [rules/methods] is a propositional logic for deducing/concluding/inferring/reasoning to/about $l_2$ (du'u) with propositions $xu_2$.
ruaqjuo	xusnoi	$x_{1}$ is a message with message subject -asserted $x_{2}$ with send message-assert $x_{3}$ with receive message $x_{4}$.
ruaqjuna	xusyje'u	$x_1$ is allegedly true/claimed to be true but has not been proved
dıemtue	zaircu'u	$c_1$ is a marketing /business/activity/function for goods/products/services/activities $z_2$.
dıemjıome	zairdijgunma	$x_1=g_1$ is a shopping mall/shopping centre of stores $x_2=g_2=z_1$
dıemkeoıtue	zairsnucu'u	$c_1$ is  the marketing communications business/activity/function supporting the sales/promotion of goods/products/services/activities $z_2$.
dıemtoaı	zaisle	$z_1=s_1$ is a shop/store of market/mall $s_2$, selling $x_3=z_2$, operated by $x_4=z_3$.
gıdıeqkue	zanbe'icku	$x_1=cukta_1$ is a book/gospel/evangel about messaged good news $x_2=cukta_2$ by author $x_3=cukta_3$ for audience $x_4=cukta_4$ preserved in medium $x_5=cukta_5$
gıcuaırıaq	zancimstu	$s_1=c_1=z_1$ is an oasis.
gıkuq	zansku	$x_1=c_1$ expresses compliment $x_2=c_2=z_1$ to $x_3=c_3=z_3$.
baıtue	zbacu'u	$c_1$ is a/the production/building/assembling function/activities involving person(s) $c_2=z_1$(ind./mass) making/building/assembling $z_2$ out of $z_3$.
baılojı	zbalogji	$x_1$ is intuitionistic logic / constructive logic for inferring/deducing $x_2$ (du'u)
baıdıu	zbaske	$s_1$ is the engineering/technology of/behind products $z_2$ made of materials/parts/components $z_3$.
buabuı	zdabartu	$b_1$ is outdoors.
buacıa	zdacau	$c_1$ is homeless.
buashaqkıao	zdacravro	$v_1$ is a hall door/front door of nest/house/lair/den $v_2=z_1=c_2$.
buapuefuq	zdacutci	$x_1$ is a slipper/houseshoe for covering/protecting/keeping warm [feet] $x_2$, and of material $x_3$.
buagea	zdaga'u	$g_1$ is an attic of house $z_1$, which is inhabited by $z_2$.
buaguaı	zdagu'a	$x_1$ does housework $x_2$ in order to clean/maintain house $x_3$
buatıshaı	zdali'a	$x_1=c_1$ leaves/departs/separates from the house inhabited by $x_2=z_2=c_2$, along route $x_3=c_3$
buanıe	zdane'i	$n_1$ is indoors.
bualueq	zdase'u	$s_1$ is a house servant in/of house $z_1$ owned by person $s_2=z_2$.
buacue	zdatru	$c_1$ is a master/ruler of home $t_2=z_1$.
jeaqca	zenri'a	$r_1$ (event/state) increases/increments/augments $x_2=z_1$ in property/quantity $x_3=z_2$ by amount $x_4=z_3$.
sıhuo	zgatirna	$t_1=z_1$ listens to $t_2=z_2$ against background noise $t_3$ under conditions $z_4$.
gıaqfaq	zgifau	$f_1$ is a musical event with music $x_2=z_1$ performed/produced by $x_3=z_2$ (event).
gıaqtoaılaı	zgika'usni	$s_1$ is a music note (symbol).
gıaqpoq	zgipre	$x_1=p_1=z_2$ is a musician, associated with music of style/genre/type $x_2=z_1$.
sheıjuao	zi'ejva	$j_1$ is the right for $z_1$ to do $z_2$ (event/state).
sheısho	zi'erbi'o	$z_1=b_1$ becomes free to do/be $x_2$ (event/state) under conditions $x_3$.
sheıtoa	zi'evla	$x_1=v_1=z_1$ is an irregular/free-form content word meaning $x_2=v_2=z_2$ in language $x_3=v_3$ (usually Lojban); $x_1$ is a stage-4 or stage-3 fu'ivla.
sheıtı	zi'ezva	$j_1$ is the right for $z_1$ to do $z_2$ (event/state). 
sheımoe	zifcni	$x_1$ feels free to do/be $x_2$
sheıshoe	zifcru	$x_1$ releases $x_2$ to do/be $x_3$ under conditions $x_4$.
sheıkunapaq	zifyjufpau	$x_1$ is is a free modifier (word or construct which can be freely inserted into or deleted from a sentence without making it ungrammatical)
taosuaı	zuksutra	$s_1=z_1$ hurries to do $z_2$ for purpose $z_3$
taojaq	zuktce	$m_1=z_1$ is [busy doing]/[working hard at] $z_2$ for purpose/goal $z_3$.
taogıqmoaq	zuktolmo'i	$x_1$ (agent) forgets to do $x_2$ (ka)
taocuedoeme	zuktruci'e	$c_1=t_1=z_1$ is the executive branch of the government of people/territory/domain/subjects $t_2$ of organizational type $c_2$ with components $c_3$.
taojara	zukybajra	$b_1=z_1$ goes jogging on surface $b_2$ for purpose $z_3$.
taolao	zukyde'a	$z_1=d_1$ is hesitant/is reluctant/hesitates/lingers in employing means/taking action $z_2=d_4$ because of $z_3$, waiting until $d_2$ at state $d_3$
taodeq	zukyka'e	$k_1$ has volition/is a volitional entity.
tırıe	zvabi'i	$x_1$ is located between/among/within $x_2$ (plural)
tıpoq	zvapre	$x_1$ is someone present at $x_2$
tıchıa	zvatcu	$x_1$ needs to be present at location $x_2$ for purpose/action $x_3$
